a	nach, zu, an, in, am
abajo	herab, herunter, unten
abre	
abril	April
abrir	etw. sperrangelweit öffnen, etw. aufmachen, etw. aufschlagen, etw. öffnen, Bauklötze staunen, neue Horizonte eröffnen, Platz machen, seinen Horiziont erweitern
acaba	
acabar	etw. beenden, mit etw. aufhören, gerade etw. getan haben, soeben / eben etw. getan haben, enden
acabo	
acabó	
acaso	vielleicht, Zufall
acceder	in etw.  einwilligen, zu etw. Zugang haben
accept-encoding accept	
accesibilidad	
acceso	Anfall, Hustenanfall, Zugang
accesorios	Zubehör  ], Accessoire
accionante	
acciones	
acción	Aktie, Aktion, Shoppen, Handlung, Tat
acerca	was ... betrifft, bei, bezugnehmend auf, bezüglich, hinsichtlich, in Bezug auf, zu, über
acondicionado	
actitud	Einstellung, Verhalten, Körperhaltung
actividad	Aktivität, Betätigung, Sonnenaktivität, Tätigkeit
actividades	
activo	aktiv, lebendig, lebhaft
activos	monetäre Vermögensobjekte
acto	Akt, Geschlechtsakt, Unüberlegtheit, Geschlechtsakt, Veranstaltung
actor	Darsteller, Synchronsprecher, Nebendarsteller, Hauptdarsteller, Schauspieler, Nebendarsteller, Nebenfigur
actores	
actos	Akt, Geschlechtsakt, Unüberlegtheit, Geschlechtsakt, Veranstaltung
actual	aktuell, augenblicklich, gegenwärtig
actualidad	Aktualität, Gegenwart
actualización	Update
actualmente	augenblicklich, derzeit, jetzt, zurzeit 
acuerdo	Abkommen, Handelsabkommen, Freihandelsabkommen, Einigung, Vereinbarung, Vertrag, Übereinkunft
acuerdos	Abkommen, Handelsabkommen, Freihandelsabkommen, Einigung, Vereinbarung, Vertrag, Übereinkunft
acá	hier
adecuado	adäquat, angemessen, geeignet, passend, tauglich, zweckmäßig
adelante	voraus, vorne, vorwärts
además	außerdem, daneben, darüber hinaus, außer, neben, zusätzlich zu, ferner, obendrein, zudem, überdies
adicionales	
adicionalmente	darüber hinaus
adiós	
administración	Militärverwaltung, Verwaltung
administrativa	Verwaltungsangestellte
administrativo	Verwaltungs-, Verwaltungsangestellter
adquirir	etw. erwerben, etw. annehmen, kaufen
adultos	Erwachsene, Erwachsener
adónde	
aeropuerto	Airport, Flughafen, Flugplatz
afines	
afirma	
afirmó	
afuera	draußen, hinaus
agencias	Agentur, Entwicklungsagentur, Presseagentur, Nachrichtenagentur, Presseagentur, Reisebüro
agenda	Terminkalender
agente	Agentin, Polizeibeamtin, Vertreterin, Agent, Krebserreger, Krebserreger, Polizeibeamter, Polizist, Werbeagent, Reiseveranstalter, Backtreibmittel, Krebserreger, Geheimagent, Vertreter
agosto	August  
agregó	
agua	Wasser
ah	
ahi	da, dort
ahora	jetzt, gerade, soeben, sofort, nun, nunmehr
ahí	da, dort, dort drüben, gleich dort drüben
aire	Klimaanlage, Druckluft, Druckluft, Pressluft, Frischluft, Luft, Wind
aires	Klimaanlage, Druckluft, Druckluft, Pressluft, Frischluft, Luft, Wind
al	ins, in, im, aufs
alberto	
alcalde	Bürgermeister
alcaldía	Rathaus, Bürgermeisteramt
alcance	Reichweite
alcanzar	jdm. etw. reichen, an etw.  / zu etw. gelangen, etw. erreichen, gelingen
alegra	
alegro	
alejandro	
alemania	
alerta	aufmerksam
algo	etwas
alguien	jemand 
alguna	einmal
algunas	manchmal, einmal
algunos	einige, jemand
algún	eines Tages, irgendein
alimentación	Stromversorgung, Ernährung
alimentos	Tiefkühlkost, Grundnahrungsmittel, Lebensmittel, Nahrungsmittel, Nahrung
allá	dort
allí	da, dort, dort drüben, dort drüben
alojamiento	Beherbung, Einquartierung, Quartier, Unterbringung, Unterkunft
alquiler	Fahrradverleih, Radverleih, Autovermietung, Miete, Pacht
alrededor	etwa, in der Nähe von, ringsherum um, circa , ungefähr, herum, ringsherum, Umgebung, Umkreis, Umland
alta	Hochsee, Hightech   oder ], Hochtechnologie, Hochspannung
alternativa	Alternative
alto	hoch, Hochofen, groß, laut, Waffenstillstand
altos	Hochofen, groß, laut, Waffenstillstand
altura	Größe, Höhe
am	
ambas	
ambiental	
ambiente	Arbeitsklima, Ambiente, Atmosphäre, Stimmung, Umgebung
ambos	beiderseits, beide
amiga	Freundin
amigo	Tierfreund, Freund, Wichteln, Kumpel, Brieffreund, Wichteln, enger Freund
amigos	Tierfreund, Freund, Wichteln, Kumpel, Brieffreund, Wichteln, enger Freund
amo	Hausmann, Herr, Besitzer
amor	Liebe
amplia	
amplio	geräumig, umfangreich, ausführlich, umfassend, vielfältig
américa	
analizar	jdn./etw. analysieren, jdn./etw. untersuchen, etw. auswerten
and	
anda	
android	
andrés	
animales	
anoche	gestern Abend, gestern Nacht
ante	im Angesicht der Tatsache, dass ..., angesichts, vor, Elch, Wildleder
anterior	bisherig, ehemalig, früher, vorausgehend, vorhergehend, vorherig
anteriores	
antes	im Angesicht der Tatsache, dass ..., bevor, vor Christus , im Vorfeld von, vor Christi Geburt, vor, bevor, lieber, in erster Linie, vor allem, zunächst, vorher, zuvor, früher, davor, angesichts, vor, Elch, Wildleder
antiguo	alt, alt, ehemalig, antik
antioquia	
antonio	
anunciar	etw. ankündigen
anuncio	Annonce, Anzeige, Aushang, Inserat, Werbespot, Werbespot
anuncios	Inserate, Annonce, Anzeige, Aushang, Inserat, Werbespot, Werbespot
anunció	
análisis	Analyse, Harnanalyse, Blutuntersuchung, Untersuchung
anúncios	
aparece	
aparición	Auftritt, Ausbruch, Fernsehauftritt, Erscheinen
apartamento	Apartment, Appartement, Ferienwohnung, Wohnung
apenas	kaum, selten, gerade als, knapp, nicht ganz
apertura	Eröffnung, Öffnung
aplicaciones	
aplicación	Anwendung, Applikation
aplicar	etw. anlegen, etw. anwenden, eine Regel durchsetzen, verwenden
aportes	Beitrag
apoyo	Beistand, Sonderbudget, Stütze, Unterstützung
aprender	lesen und schreiben lernen, etw. lernen
aprendizaje	Berufsausbildung, Lehre
aproximadamente	circa 
apuesto	
aquel	jener, dieser, jener
aquellas	
aquellos	
aqui	hier, gleich hier
aquí	hier, gleich hier
aranda	
archivo	Archiv, Datei, Verzeichnis
argentina	Argentinierin
argumentos	Argument, Totschlag-Argument, Totschlagargument, Handlung
arma	
armas	
arriba	oben
arriendo	
arte	Straßenkunst, Volkskunst, Kunst
artes	Kampfsportarten, Straßenkunst, Volkskunst, Kunst
artistas	Programmierkünstlerin, Künstlerin, Artistin, Zirkusartist, Programmierkünstler, Künstler, Artist
artículo	Artikel  , Geschlechtswort, Handelsware, bestimmter Artikel, Leitartikel, Luxusartikel, Zeitungsartikel, bestimmter Artikel, Haushaltsware, unbestimmter Artikel, Paragraph, Ware
artículos	Toilettenartikel, Artikel  , Geschlechtswort, Handelsware, bestimmter Artikel, Leitartikel, Luxusartikel, Zeitungsartikel, bestimmter Artikel, Haushaltsware, unbestimmter Artikel, Paragraph, Ware
asegura	
aseguró	
aseo	Körperpflege, Toilette
asesino	Serienkiller, Serienmörder, Mörder, Massenmörder, Serienkiller, Serienmörder
asesor	Berater, Steuerberater
asi	auf diese Weise, so
asistencia	Beihilfe, Betreuung, medizinische Versorgung, ärztliche Betreuung, postoperative Versorgung  des Patienten
asociación	Bund, Mieterbund, Gesellschaft  , Verband, Vereinigung, Verein, Blindenverein
asp	
aspecto	Erscheinung, Aspekt, Aussehen, Erscheinungsbild
aspectos	Erscheinung, Aspekt, Aussehen, Erscheinungsbild
asunto	Affäre, Angelegenheit, Betreff, Privatangelegenheit, Thema
así	auf diese Weise, sowie, so oder so, somit, also, sodass, so, dennoch
ataque	Anfall, Angriff, Luftangriff, Herzanfall, Herzattacke, Herzanfall, Herzattacke, Schlaganfall, Schlaganfall, Wutanfall, Lachanfall, Einsatz, Atomangriff, Selbstmordanschlag
atención	Achtung, Aufmerksamkeit, medizinische Versorgung
atlántico	atlantisch
atrás	hinten, nach hinten, zurück
aulas	
aumento	Anstieg, erhöhte Marktanteile, Gewichtszunahme, Preissteigerung, Lohnerhöhung, Gehaltserhöhung, Gehaltserhöhung, Lohnerhöhung, Vermehrung, Zunahme, Erhöhung
aun	bei alledem, trotz alldem, trotz alledem, trotz allem, trotzdem, auch wenn, selbst wenn, sogar wenn
aunque	aber, auch wenn, gleichwohl, obgleich, obwohl, selbst wenn
auto	Beschluss, Auto
autor	Autor, Schriftsteller
autoridades	Behörde, Ämter
auxiliar	Hilfs-, Flugbegleiterin, Arzthelfer, Flugbegleiter, Steward
avances	Vormarsch
aviso	Bescheid, Kündigung, Hinweis, Warnung, Anzeige, Benachrichtigung, Mitteilung
avisos	Bescheid, Kündigung, Hinweis, Warnung, Anzeige, Benachrichtigung, Mitteilung
avión	Tankflugzeug, Mehlschwalbe, Frachtflugzeug, Großraumflugzeug, Aufklärungsflugzeug, Flugzeug, Tankflugzeug, Felsenschwalbe, Uferschwalbe
ay	aua
ayer	gestern
ayuda	Beihilfe, Beistand, Hilfe, Mithilfe
ayudar	jdm. helfen
azul	blau, himmelblau, hellblau, marineblau, dunkelblau, Blau
año	Studienjahr, Schaltjahr, Wahljahr, Schuljahr, Jahr, Klasse, Lichtjahr  
años	Schulzeit, Studienjahr, Schaltjahr, Wahljahr, Schuljahr, Jahr, Klasse, Lichtjahr  
aún	bislang, noch, noch nicht, immer noch
baja	Niederspannung, Mutterschaftsurlaub, Urlaub, Rückgang
bajo	kalorienarm, fettarm, eidesstattlich, niedrig, unter keinen Umständen, tief, unter Tage, unter, klein, leise, Bass, Saum
banco	Bank, Notenbank, Zentralbank, zentrale Notenbank, Zentralnotenbank, Sandbank, Datenbank, Prüfstand, Nebelbank, Fischschwarm, Prüfstand, Blutbank, Werkbank
banda	Breitband, Musikkapelle, Spielmannszug, Soundtrack, Band
bandas	Breitband, Musikkapelle, Spielmannszug, Soundtrack, Band
barcelona	
barco	Ausflugsdampfer, Dampfschiff, Segelboot, Fischerboot, Schiff
barranquilla	
barrio	Bezirk, jüdisches Viertel, Nachbarschaft, Stadtviertel, Viertel, Stadtteil
base	Luftwaffenstützpunkt, Basis, Rettungswache, Datenbank, Grundlage, Steuerbemessungsgrundlage, Militärstützpunkt, Flottenstützpunkt, Stützpunkt, Kartengrund
bases	Luftwaffenstützpunkt, Basis, Rettungswache, Datenbank, Grundlage, Steuerbemessungsgrundlage, Militärstützpunkt, Flottenstützpunkt, Stützpunkt, Kartengrund
basta	
bastante	ausreichend, genug, genügend, ziemlich, ziemlich viel
batalla	Feldschlacht, Schneeballschlacht, Kampf, Seeschlacht, Schlacht
baño	Bad, Herrentoilette, Damentoilette, Blutbad, Sonnenbad, Lokus, Wasserbad, Toilette, Badezimmer
baños	Schlammbäder, Bad, Herrentoilette, Damentoilette, Blutbad, Sonnenbad, Lokus, Wasserbad, Toilette, Badezimmer
bebé	Baby, Kleinkind, Frühchen, Frühgeborenes
belleza	Schönheit
bello	hübsch, schön
beneficios	Ertrag, Gewinn, Profit
biblioteca	Bibliothek, Bücherei
bien	bekannt, renommiert, sittsam, höflich, wohlerzogen, gut, gut durchgebraten, gut aussehend, richtig, Gemeinwohl
bienes	Immobilien
bienestar	Wohlbefinden
bienvenido	willkommen
blanco	schneeweiß, hellhäutig, weiß, Ziel
boca	Maul, Mundstück, Mund, Schnittstelle, Eingang, Loch, Mündung, Schere, Einfahrt, Flussmündung, Schlund, Öffnung
bogota	
bogotá	
bolívar	Bolivar
bonito	hübsch, schmuck, schön, reizend, Echter Bonito, Thunfisch
boyacá	
brasil	
bucaramanga	
buen	gute Reise
buena	Glück, gute Erziehung, gepflegtes Äußeres, Glückssträhne
buenas	Glück, gute Erziehung, gepflegtes Äußeres, Glückssträhne, guten Abend, guten Tag
buenaventura	
bueno	artig, gut, nun, also, brav
buenos	guten Morgen, guten Tag, gute Manieren, also, brav
buenos aires	
busca	Suche
buscador	Suchmaschine
buscan	
buscando	
buscar	jdm./etw. nachgehen, jdn./etw. holen, etw. anstreben, etw. suchen, nach etw.  streben, einen Streit vom Zaun brechen, ein Wort nachschlagen
busco	
by	
búsqueda	Suche, Fahndung
búsquedas	Suche, Fahndung
caballeros	Ritter, Gentleman, Kavalier, Herr
cabeza	Knoblauchknolle, Sündenbock, Kopf, Atomsprengkopf, Skinhead
cabo	Gefreiter  , Kap, Tau, Seil, Stumpf
cada	jedermann, jeden Sonntag, jeden Tag, täglich, jede, jeder, jedes, jedermann, jeder, jedes Mal, immer mehr
cadena	Nahrungskette, Nahrungskette, Schneekette, Zerfallsreihe, Fließband, Montageband, Kühlkette, Modekette, Bergkette, Menschenkette, Kette, Bergkette, Gebirgszug, lebenslängliche Freiheitsstrafe, lebenslängliches Zuchthaus, Nahrungskette, Sender
café	Espresso  mit Kondensmilch, Milchkaffee, doppelter Espresso, Irish Coffee, Kaffee, gemahlener Kaffee, Espresso, Café
caja	Sparkasse, Getriebe, Pappschachtel, Tresor, Streichholzschachtel, Baukasten, Besteckkasten, Sicherungskasten, Werkzeugkoffer, Kosmetikkoffer, Spieldose, Spieluhr, Krankenkasse, Dose, Safe, Tresor, Karton, Kasse, Kasten, Kiste, Blackbox, Schachtel, Fernseher, Flimmerkiste, Glotze, Brustkorb, Thorax, Sarg
caldas	
cali	
calidad	Luftqualität, Lebensqualität, Qualität, Eigenschaft
calificación	
calle	Straße  , Bahn, Vorfahrtstraße, Einbahnstraße, Hauptverkehrsstraße
calzado	beschuht, Fußbekleidung, Schuhe, Schuhwerk
cama	Bett, Wasserbett, Doppelbett, Sonnenbank, Sonnenbank
cambiar	jdn. umquartieren, etw. umbenennen, etw. verändern, etw. wechseln, etw. ändern, etw. für etw. eintauschen, es sich  anders überlegen, seine Meinung ändern, seine Meinung ändern, Geld umtauschen, Geld wechseln, das Thema wechseln, umsteigen
cambio	Automatikgetriebe, Klimawandel, Kulturwandel, Ölwechsel, Nabenschaltung, Ballwechsel, Umschichtung, Jahrhundertwechsel, Jahrhundertwende, Stimmbruch, Generationswechsel, Veränderung, Wandel, Geldwechsel, Kleingeld, Wechselgeld, Austausch
cambios	Automatikgetriebe, Klimawandel, Kulturwandel, Ölwechsel, Nabenschaltung, Ballwechsel, Umschichtung, Jahrhundertwechsel, Jahrhundertwende, Stimmbruch, Generationswechsel, Veränderung, Wandel, Geldwechsel, Kleingeld, Wechselgeld, Austausch
camino	Schulweg, Schulweg, Gartenweg, Treidelpfad, Fußgängerweg, Pfad, Weg, Straße, Strecke
camioneta	
campaña	Hetzkampagne, Schmutzkampagne, Wahlkampf, Kampagne
campeón	Champion, Weltmeister, Meister, Schachweltmeister
campo	Acker, Auffanglager, Anwendungsbereich, Anwendungsgebiet, Flugfeld, Gefechtsfeld, Schlachtfeld, Konzentrationslager  , Sportplatz, Trainingslager, Vernichtungslager, Fußballfeld, Fußballplatz, Golfplatz, Minenfeld, Strahlenfeld, Strahlungsfeld, Flüchtlingslager, Feld, Magnetfeld, Erdölfeld, Vektorfeld, Blickfeld, Land, Bereich, Gebiet
campos	Acker, Auffanglager, Anwendungsbereich, Anwendungsgebiet, Flugfeld, Gefechtsfeld, Schlachtfeld, Konzentrationslager  , Sportplatz, Trainingslager, Vernichtungslager, Fußballfeld, Fußballplatz, Golfplatz, Minenfeld, Strahlenfeld, Strahlungsfeld, Flüchtlingslager, Feld, Magnetfeld, Erdölfeld, Vektorfeld, Blickfeld, Land, Bereich, Gebiet
canal	Abwasserleitung, Geburtskanal, Bewässerungskanal, Kanal, Fleet
canciones	
canción	Wiegenlied, Lieblingslied, Lied
candelaria	
candidato	Kandidat, Bewerber
candidatos	Kandidat, Bewerber
cantidad	Menge, Anzahl, Geldbetrag, Summe
capacidad	Hörvermögen, Anpassungsfähigkeit, Denkvermögen, Reaktionsfähigkeit, Fähigkeit, Denkvermögen, Rechtsfähigkeit, Können, Denkvermögen, Wärmekapazität
capacitación	
capital	Provinzhauptstadt, Hauptstadt, Großstadt, Kapital, Eigenkapital
capitán	
caquetá	
cara	Kopf oder Zahl, Kopf oder Zahl, Kindergesicht, Gesicht
características	Gemeinsamkeit, Eigenschaft, Merkmal
carajo	
carga	Belastung, Bürde, Fracht, Hohlladung, Ladung, Last, Nennlast
cargo	Lastschrift, Anklage, Vorwurf, Funktion, Tätigkeit, Amt
cargos	Lastschrift, Anklage, Vorwurf, Funktion, Tätigkeit, Amt
caribe	
cariño	mein Liebes, Zuneigung, Liebkosung
carlos	
carne	weißes Fleisch, Wild, Kanonenfutter, Schweinefleisch, Lammfleisch, Gänsehaut, Rindfleisch, Kalbfleisch, Rindfleisch, Rindfleisch, Eberfleisch, Fleisch, frisches Fleisch, mageres Fleisch, Hackfleisch, Hackfleisch, rotes Fleisch
carrera	Pferderennen, Radrennen, Autorennen, Staffellauf, Sackhüpfen, Hürdenlauf, Karriere, Rennen, Studium
carreras	Pferderennen, Radrennen, Autorennen, Staffellauf, Sackhüpfen, Hürdenlauf, Karriere, Rennen, Studium
carretera	Nebenstraße, Umgehungsstraße, Ringstraße, gebührenpflichtige Straße, mautpflichtige Straße, Mautstraße, gebührenpflichtige Straße, mautpflichtige Straße, Mautstraße, Landstraße, Schnellstraße
carro	Einkaufswagen, Wagen, Auto, Karren
carros	Einkaufswagen, Wagen, Auto, Karren
carta	Speisekarte, Brief, Liebesbrief, Abschiedsbrief, Bewerbungsschreiben, Empfehlungsschreiben, Karte, Urkunde, Landkarte
cartagena	
carácter	Buchstabe, Charakter, Sonderzeichen, Temperament, Wesen
casa	Reihenhaus, Höhlenwohnung, Wechselstube, Landhaus, Bordell, Rettungswache, Unfallstation, Doppelhaus, Haus, Elternhaus, Königshaus, Landgasthaus, Familiensitz, Gutsherrenhaus, Herrenhaus, Stammsitz
casas	Reihenhaus, Höhlenwohnung, Wechselstube, Landhaus, Bordell, Rettungswache, Unfallstation, Doppelhaus, Haus, Elternhaus, Königshaus, Landgasthaus, Familiensitz, Gutsherrenhaus, Herrenhaus, Stammsitz
casi	beinahe, fast, fast gar nicht, kaum, fast nie, fast immer
caso	falls, im Falle, dass, Krankheitsfall, Insolvenzfall, Invaliditätsfall, Fall, Kasus, hoffnungsloser Fall, Sache, Umstand
casos	falls, im Falle, dass, Krankheitsfall, Insolvenzfall, Invaliditätsfall, Fall, Kasus, hoffnungsloser Fall, Sache, Umstand
categoría	
cauca	
causa	Ursache und Wirkung, Todesursache, Hauptgrund, Ursache, Grund, Verfahren
cc	
celebración	Hochzeitsfeier, Feier
celular	zellulär, Handy, Mobiltelefon
central	zentral, Hauptpostamt, Kommandozentrale, Wasserkraftwerk, Atomkraftwerk, Hauptstelle, Zentrale
centro	Klinikum, Einkaufszentrum, Schwerpunkt, Stadtmitte, Stadtzentrum, Mittelfeld, Bearbeitungszentrum, CNC-Bearbeitungszentrum, Herz, Altstadt, Mitte, Haftanstalt, Zentrum, Innenstadt
centros	Klinikum, Einkaufszentrum, Schwerpunkt, Stadtmitte, Stadtzentrum, Mittelfeld, Bearbeitungszentrum, CNC-Bearbeitungszentrum, Herz, Altstadt, Mitte, Haftanstalt, Zentrum, Innenstadt
cerca	bei, in der Nähe von, nah, Zaun
chapinero	
chevrolet	
chica	junge Frau, Kind, Mädchen, Mädel
chicas	Mädchen, junge Frau, Kind, Mädchen, Mädel
chico	klein, junger Mann, Junge, Kind, Knabe
chicos	Jungen, junger Mann, Junge, Kind, Knabe
chile	Chili
cielo	Himmel, Nachthimmel
ciencia	Wissenschaft
ciencias	Naturwissenschaften, Politikwissenschaften, Politikwissenschaft, Wissenschaft
ciento	hundertzehn, hundert, hundertdrei, einhunderteins, hunderteins, hunderteinundzwanzig
cierra	
cierto	bestimmt, gewiss, richtig, sicher, wahr
cinco	fünf
cine	Kino
ciudad	Stadtstaat, Geisterstadt, Grenzstadt, Zwillingsstadt, Partnerstadt, Geburtsstadt, Arbeiterstadt, Hafenstadt, Stadt, Studentenstadt, Universitätsstadt, Campus
ciudadanos	Bürger
ciudadanía	Bürgersinn, Staatsangehörigkeit
ciudades	
civil	Zivil-, zivil
civiles	
cl	
claro	eindeutig, einwandfrei, klar, deutlich, hell, Mondschein
clase	Flugstunde, naturwissenschaftlicher Unterricht, Spanischunterricht, Klasse, Arbeiterklasse, Sorte, Arbeiterklasse, Unterricht, Unterrichtsraum
clases	Flugstunde, naturwissenschaftlicher Unterricht, Spanischunterricht, Klasse, Arbeiterklasse, Sorte, Arbeiterklasse, Unterricht, Unterrichtsraum
clasificación	
clasificados	
claudia	
clic	
cliente	Klientin, Kundin, Klient, Kunde
clientes	Klientin, Kundin, Klient, Kunde
close	
club	Club, Klub, Nachtklub, Verein
cm	
coche	Auto, gepanzerter Wagen, Schlafwagen, Gefangenentransportfahrzeug, Speisewagen, Zugrestaurant, Mietwagen, Pferdekutsche, Mittelklassewagen, Spielzeugauto, Firmenwagen, Geschäftswagen, Kinderwagen, Leichenwagen, Rostlaube, Kleinwagen, Zugrestaurant, Kleinwagen, Mittelklassewagen, Wagen
cocina	asiatische Küche, Feldküche, Gasherd, Elektroherd, Kochen, Kochkunst, Küche, Küche, Herd, Kochherd
colaboración	Beteiligung, Zusammenarbeit
colegio	Anwaltskammer, Ärztekammer, Schule
colombia	
colombiana	Kolumbianerin
colombiano	kolumbianisch, Kolumbianer
colombianos	Kolumbianer
color	kaffeebraun, Hautfarbe, Augenfarbe, Haarfarbe, Farbe, Lieblingsfarbe, Primärfarbe
combate	Kampf
comentario	Kommentar
comentarios	Kommentar
comenzó	
comer	essen, etw. fressen, etw. aufessen, vegetarisch essen
comercial	geschäftlich, Geschäfts-, Handels-
comerciales	
comercialización	
comercio	Großhandel, Einzelhandel, Außenhandel, Handel, Binnenhandel, Buchhandel, Seehandel, Einzelhandel
comida	Hausmannskost, Henkersmahlzeit, Henkersmahl, Bio-Lebensmittel, Essen, Mahlzeit, Hauptmahlzeit, Fastfood, Mittagessen, Gericht
comienza	
comisión	Ausschuss, Bankgebühr, Kommission, Provision, Rechtshilfeersuchen
comité	Ausschuss, Komitee
como	als, wie zuvor, infolge, wie üblich, wie überall, richtig, höchstens, wenigstens, wie üblich, wie immer, wie üblich, als ob nichts geschehen wäre, als ob, als wenn, wahnsinnig, haushoch, riesig, kindisch, wie Pech und Schwefel, weil, wie, da
compartir	etw. teilen
compañía	Ensemble, Theatertruppe, Fluggesellschaft, Firma, Fähnlein, Gesellschaft, Reederei, Begleitung
competencia	Rechtsmittelbefugnis, Konkurrenz, Wettbewerb, Kompetenz
competencias	Rechtsmittelbefugnis, Konkurrenz, Wettbewerb, Kompetenz
completa	
completamente	ganz, komplett, pudelwohl, völlig
completo	komplett, vollständig, belegt, besetzt
comportamiento	Benehmen, Verhaltensweise, Verhalten
compra	Barkauf, Ankauf, Anschaffung, Ratenkauf, Sicherungskauf, Einkauf, Festkauf, Erwerb, Scheinkauf, Finanzierungskauf, Spontankauf, Grundstückskauf, Kauf, Übernahme
comprar	etw. einkaufen, etw. kaufen, auf Raten kaufen
compras	Hamsterkäufe, Einkäufe, Barkauf, Ankauf, Anschaffung, Ratenkauf, Sicherungskauf, Einkauf, Festkauf, Erwerb, Scheinkauf, Finanzierungskauf, Spontankauf, Grundstückskauf, Kauf, Übernahme
compromiso	Verlobung, Engagement, Kompromiss  ], Verpflichtung
computación	
comunicación	Kommunikation, Verbindung
comunicado	Pressemitteilung, amtliche Mitteilung, offizielle Mitteilung
comunidad	autonome Region, Glaubensgemeinschaft, Gemeinschaft, Allgemeinheit, Gemeinsamkeit
comunidades	
común	gemeinsam, zusammen, gewöhnlich
con	mit
concejo	Gemeinderat, Stadtrat, Stadtrat
concentración	Sauerstoffkonzentration, Salzkonzentration, Gehalt, Konzentration, Flurbereinigung
concepto	Auffassung, Begriff, Funktionsbegriff, Ehrbegriff, Konzept, Meinung
conceptos	Auffassung, Begriff, Funktionsbegriff, Ehrbegriff, Konzept, Meinung
conciencia	Umweltbewusstsein, Bewusstsein, Umweltbewusstsein, Umweltbewusstsein, Gewissen
conciertos	Violinkonzert, Konzert
concreto	genau, konkret, präzise, kompakt, prägnant, bestimmt, fest, Beton
condiciones	Wohnverhältnisse, Lieferungsbedingungen, Zahlungsbedingungen, allgemeine Geschäftsbedingungen  , Arbeitsbedingungen
condición	Bedingung, Voraussetzung, Vorbedingung, Zustand
conexión	Internetverbindung, Anschluss, Verbindung, Zusammenhang
conferencia	Friedenskonferenz, Konferenz, Ferngespräch
confianza	Vertrauen, Zuversicht
confidencial	vertraulich
conflicto	Auseinandersetzung, Zuständigkeitsstreit, Gesetzeskonflikt, Konflikt, Arbeitskonflikt, Nord-Süd-Konflikt, Streit
conformidad	
congreso	Parteitag, Kongress
conjunto	Menge, Gruppe
conmigo	bei mir, mit mir
connection	
conoce	
conocer	jdn. kennen, jdn. kennen lernen
conoces	
conocida	Bekannte
conocido	bekannt, bewundert, Bekannter
conocimiento	Bewusstsein, Kenntnis, Wissen
conocimientos	Kenntnisse, Bewusstsein, Kenntnis, Wissen
conozco	
consecuencia	Konsequenz, Auswirkung, Ergebnis, Folge, Wirkung
conseguir	etw. an Land ziehen, etw. auftreiben, etw. bekommen, etw. erlangen, etw. erreichen
consejo	Aufsichtsrat, Empfehlung, Ratschlag, Rat
considera	
considerar	etw. als etw. betrachten, etw. für etw. halten
consiguió	
constitucional	Verfassungs-, verfassungsmäßig
constitución	Verfassung
construcción	Aufbau, Bauen, Baugewerbe, Bauweise, Bauwerk, Bau, Erbauung, Gebäude, Konstruktion
construir	etw. bauen, etw. konstruieren
consulta	Volksbefragung, Rücksprache, Praxis, Sprechzimmer
consumo	Kraftstoffverbrauch, Ressourcenverbrauch, Energieverbrauch, Konsum, Verbrauch
contable	zählbar, Buchhalterin, Buchhalter
contacto	Kontakt, Funkkontakt
contar	etw. haargenau erzählen, etw. erzählen, rechnen mit, einen Witz erzählen, zählen
contenido	Koffeingehalt, Gehalt, Inhaltsverzeichnis, Inhalt
contenidos	Koffeingehalt, Gehalt, Inhaltsverzeichnis, Inhalt
contexto	Kontext, Zusammenhang
contiene	
contigo	mit dir
continuación	Fortsetzung
continuar	fortsetzen, mit etw. weitermachen, fortfahren
contra	entgegen, gegen, gegenüber, per Nachnahme, gegen alle Schwierigkeiten
contrario	Gegenteil, Gegner
contratación	Einstellung
contrato	Mietvertrag, Kaufvertrag  mit Eigentumsvorbehalt, Kaufvertrag, Arbeitsverhältnis, befristeter Vertrag, Energieversorgungsvertrag, unbefristeter Vertrag, Arbeitsvertrag, Vertrag
contratos	Mietvertrag, Kaufvertrag  mit Eigentumsvorbehalt, Kaufvertrag, Arbeitsverhältnis, befristeter Vertrag, Energieversorgungsvertrag, unbefristeter Vertrag, Arbeitsvertrag, Vertrag
control	Dopingkontrolle, Sicherheitskontrolle, Fernbedienung, Fernsteuerung, Aufsicht, Kontrolle
convierte	
convirtió	
cooperación	Zusammenarbeit
copa	Baumkrone, Sektglas, Weltmeisterschaft, Weltmeisterschaft, Glas
corazón	Herz, Kerngehäuse
corporación	
corre	
correo	Luftpost, Einschreiben, E-Mail  ], elektronische Post, Postamt, Post, Eilpost, Bote, Kurier
corresponde	
correspondiente	jeweilig, passend, entsprechend
corte	Gericht, Hof, gestufte Frisur, Stromausfall, Haarschnitt, Schnitt, Schnittwunde
cosa	Ding, Gegenstand, Sache
cosas	Ding, Gegenstand, Sache
costa	Atlantikküste, Küste, Westküste
costo	Kosten
costos	Kosten
crea	
creación	Geldschöpfung, Erstellung, Kreation, Geldschöpfung, Schöpfung
crear	etw. erschaffen, etw. erzeugen, etw. gründen, etw. kreieren, etw. schaffen
creatividad	
crecimiento	Zellwachstum, Bevölkerungszunahme, Wirtschaftswachstum, Wachstum
cree	
creen	
creer	etw. glauben
crees	
creo	
creí	
creía	
creó	
crisis	Weltwirtschaftskrise, Wirtschaftskrise, epileptischer Anfall, Finanzkrise, Regierungskrise, Krise, Ehekrise
criterios	Kriterium, Meinung
crédito	Kredit, Kreditpunkt
cuadro	Bild, Krankheitsbild, Fahrradrahmen, Rahmen, Armaturenbrett, Gemälde, Malerei, Tabelle, Rahmen
cual	
cuales	
cualquier	irgendetwas
cualquiera	irgendein, irgendjemand, irgendwer, jedermann
cuando	als, wenn, sobald
cuanto	so bald wie möglich, so schnell wie möglich, je mehr... , desto mehr, Flussquant, Quant
cuarto	vierte, viertel, Toilette, Badezimmer, Wohnzimmer, Viertelstunde, Vorderhand, Kinderzimmer, Raum, Hinterhand, Viertel, Zimmer
cuatro	Brillenschlange, Vierauge, vier
cuenta	Countdown, Bankkonto, Girokonto, Sparkonto, Hotelrechnung, Glasperle, Konto, Rechnung
cuentas	Countdown, Bankkonto, Girokonto, Sparkonto, Hotelrechnung, Glasperle, Konto, Rechnung
cuero	Kopfhaut, Leder
cuerpo	Himmelskörper, Körper, Ärzteschaft, Festkörper, Leiche
cuidado	Altenpflege, Körperpflege, Betreuung, Pflege
culpa	Schuld
cultura	Allgemeinbildung, Kultur
cultural	kulturell
culturales	
cumplido	Kompliment
cumplimiento	Erfüllung
cumplir	etw. erfüllen, zehn Jahre  werden, die Verkehrsregeln beachten, ein Versprechen einhalten
cundinamarca	
cuotas	Arbeitslosenquote, Schulgeld, Frauenquote, Milchquote, Prämie, Anteil, Quote
curso	Studienjahr, Fortgeschrittenenkurs, Leistungskurs, Deutschkurs, Schulungskurs, Schulung, Malkurs, Intensivkurs, Klasse, Kurs, Lehrgang
cursos	Studienjahr, Fortgeschrittenenkurs, Leistungskurs, Deutschkurs, Schulungskurs, Schulung, Malkurs, Intensivkurs, Klasse, Kurs, Lehrgang
cuya	
cuyo	dessen
cuál	welcher
cuándo	wann
cuánto	wie viel, wieviel
cuántos	wie viele
cállate	
cámara	Handelskammer, Tresorraum, Tresor, Schlauch, Filmkamera, Brennkammer, Videokamera, Digitalkamera, Fotoapparat, Fotoapparat, Kamera, Kühlraum, Grabkammer, Kamera, Kammer, Zeitlupe, Magmakammer, Unterwasserkamera, Kamerafrau, Kameramann
cédula	Personalausweis
código	Barcode, Strichcode, Kode, Morsecode, Strafgesetzbuch  , Geheimcode
cómo	wie
córdoba	Córdoba
cúcuta	
da	
dado	angesichts, gegebenenfalls , gegeben, in Anbetracht, gesetzt den Fall, dass ..., da, weil, Würfel
dale	
damas	Dame
dame	
dan	
daniel	
dar	geben
darle	etw. polieren
darme	
darte	
daré	
das	
date	
datos	Daten, Angaben  zur Person, Personalien, Angabe
david	
daño	Transportschäden, Leid, Sachschaden, Schaden, Totalschaden
de	aus, von, über
debajo	darunter
debate	Debatte
debe	
debemos	
deben	
deberá	
deberán	
debería	
deberíamos	
deberías	
debes	
debido	aufgrund, infolge, wegen, gebührend
debo	
debí	
debía	
decide	
decidió	
decir	etw. sagen, jdn./etw. lobpreisen, ablehnen
decirle	
decirme	
decirte	
decisiones	
decisión	Beschluss, Entscheidung, Entschluss
declaraciones	Aussagen
declaración	Aussage, Steuererklärung, Liebeserklärung, Einwilligungserklärung, Kriegserklärung, Unabhängigkeitserklärung, Deklaration, Umsatzsteuererklärung, Erklärung
declaró	
decreto	
decía	
dedicada	
defender	jdn./etw. verteidigen, jdn./etw. vertreten, etw. behaupten
defensa	Abwehr, Fender, Verteidigung, Schutz
deja	
dejado	nachlässig
dejar	jdn./etw. verlassen, jdn. in Ruhe lassen, jdn. in Verlegenheit bringen, jdn. außer Gefecht setzen, etw. hinterlassen, etw. lassen, etw. übrig lassen, etw. leihen, jdn./etw. hinter sich lassen, etw. fallen lassen, aufhören etw. zu tun, etw. abkühlen lassen, ein Risiko eingehen, jdn. versetzen, jdm. erlauben, etw. zu tun, Spielraum lassen
dejaré	
deje	
dejes	
dejo	
dejé	
dejó	
del	östlich, ebenfalls, ebenso, nördlich, westlich, südlich
demanda	Anforderung, Anfrage, Nachfrage, Klage
demandada	
demandante	
demasiado	zu teuer, zu sehr, zu viel
democracia	Demokratie
demonios	Dämon
demás	
denominado	
dentro	innerhalb von, innerhalb, in, bald, in Kürze, in drei Tagen, gleich, drinnen, in... hinein, innen, im
departamental	
departamento	Abteilung, Amt, Behörde, Kreditabteilung, Personalabteilung, Kundendienstabteilung, Verkaufsabteilung, Vertriebsabteilung, Vertrieb, Wohnung
departamentos	Abteilung, Amt, Behörde, Kreditabteilung, Personalabteilung, Kundendienstabteilung, Verkaufsabteilung, Vertriebsabteilung, Vertrieb, Wohnung
deporte	Wassersport, Abenteuersport, Wintersport, Ausdauersport, Wassersport, Sport
deportivo	sportlich
derecho	14 Tage Widerrufsfrist, Widerrufsfrist von 14 Tagen, gerade, rechter, rechts, geradeaus, Recht  zu schweigen, Recht  auf Freizügigkeit, Urheberrecht, Widerrufsrecht, Widerrufsrecht, Widerrufsrecht, Vorkaufsrecht, Wahlrecht, Gottesgnadentum, Menschenrecht, Jura, Jus, Arbeitsrecht, Feindstrafrecht, Recht, Erbrecht
derechos	14 Tage Widerrufsfrist, Widerrufsfrist von 14 Tagen, geradeaus, Recht  zu schweigen, Recht  auf Freizügigkeit, Urheberrecht, Widerrufsrecht, Widerrufsrecht, Widerrufsrecht, Vorkaufsrecht, Wahlrecht, Gottesgnadentum, Menschenrecht, Jura, Jus, Arbeitsrecht, Feindstrafrecht, Recht, Erbrecht
derrota	Niederlage
desarrolla	
desarrollar	etw. entwickeln, etw. weiterentwickeln
desarrollo	Embryonalentwicklung, Entfaltung, Entwicklung, Wachstum, Hergang
desayuno	Frühstück
descripción	Beschreibung, Darstellung, Versionsbeschreibung, Schilderung
descubre	
desde	seit, aus, von, von, ab
desempeño	
deseo	Begierde, Wunsch
después	nachdem, anschließend, danach, nach Christus , danach, nach Christi Geburt, nach, letztlich, später
destaca	
destacó	
destino	Bestimmung, Endziel, Schicksal, Ziel
detalles	Detail, Einzelheit, Kleinigkeit, Aufmerksamkeit
determinar	etw. bestimmen
detrás	dahinter, hinter, hinter der Tür, hinten
di	
dia	
diablos	Satan, Teufel, Gauner, Griesgram
diagnóstico	Früherkennung, Diagnose
diario	täglich, Tagebuch, Tageszeitung, Zeitung
dice	
dicen	
dices	
dicha	
dicho	gesagt, nebenbei bemerkt, nebenbei gesagt, übrigens
diciembre	Dezember  
diciendo	
diego	
dieron	
diez	zehntausend, zehn
diferencia	Differenz, Zeitverschiebung, Unterschied
diferente	anders, unterschiedlich, verschieden
diferentes	
difícil	schwer zu glauben, schwer, schwierig, spröde
diga	
digas	
digital	digital
digo	sage
dije	
dijeron	
dijiste	
dijo	
dile	
dime	
dinero	Geld
dinámica	
dio	
dios	Gott
dirección	E-Mail-Adresse, Unternehmensleitung, E-Mail-Adresse, IP-Adresse, Unternehmensleitung, Leitung, Geschäftsführung, Steuerung, Anleitung, Richtung, Adresse  , Anschrift
directa	
directamente	auf direktem Weg, auf direktem Wege, direkt
directiva	Richtlinie
directo	direkt, unmittelbar
director	Dirigent, Doktorvater, Direktor, Leiter, Regisseur
diré	
diría	
discapacidad	körperliche Behinderung, geistige Behinderung
disciplina	Sportart, Disziplin, eiserne Disziplin, Sportart
disco	Ampel, Festplatte, Bandscheibe, Schallplatte
discos	Ampel, Festplatte, Bandscheibe, Schallplatte
disculpe	
discurso	Tischrede, Rede
discusión	Diskussion, Streitgespräch
diseño	Automobildesign, Modellzeichnung, Seitenaufbau, Design, Gestaltung, Industriedesign, Produktdesign, Rautenzeichnung, Städtebau, Muster, Zeichnung, Entwurf, Skizze
disfrutar	etw. genießen
dispone	
disponibilidad	Ressourcenverfügbarkeit, Verfügbarkeit
disponible	verfügbar
disponibles	
disposiciones	
disposición	Bereitwilligkeit, Disposition, Verfügung, Anordnung, Bereitschaft
dispuesto	hilfsbereit, bereit, geschickt
distancia	Distanz, Entfernung, Brennweite, Unterschied, Abstand
distintas	
distintos	
distribución	Aufteilung, Ausgabe, politische Machtverteilung, Verteilung
distrital	
distrito	Verwaltungsbezirk, Bezirk, Wahlkreis, Industriegebiet
diversas	
diversos	Verschiedenes, unterschiedlich, unähnlich, verschieden, verschiedenartig, vielfältig, vielseitig
división	Panzerdivision  
diálogo	Dialog, transatlantischer Dialog, Gespräch
doble	doppelt, Doppelte
docente	Lehrerin, Dozentin, Lehrer, Dozent
docentes	Lehrerin, Dozentin, Lehrer, Dozent
doctor	Arzt, Doktor
documento	Dokument, Personalausweis
documentos	Dokument, Personalausweis
dolor	Kopfschmerzen, Bauchschmerz, Magenschmerzen, Zahnschmerz, Schmerz
domingo	Sonntagmittag, Sonntag  
don	Begabung
donde	bei, wo
dormir	wie ein Murmeltier schlafen, auf dem Bauch schlafen, auf dem Rücken schlafen, schlafen wie ein Murmeltier, wie ein Murmeltier schlafen, schlafen, übernachten
dormitorio	Schlafzimmer
dos	zweitausend, Doppelpunkt, doppelt, zweimal, zwei Mal, zwei, zwo, C
doy	
dr	
dra.	
duda	Zweifel
duración	Dauer
durante	tagsüber, in, wochenlang, zeitlich befristet, während
duro	hart, zäh, Duro
década	Jahrzehnt
déjame	
déjeme	
día	Tag
dólares	
dónde	überall, wo
e	und 
economía	Hauswirtschaft, Weltwirtschaft, Schattenwirtschaft, Schattenwirtschaft, Wirtschaft
económica	
económicas	
económico	wirtschaftlich, sparsam, ökonomisch
económicos	sparsam
ecopetrol	
ecuador	Äquator
edad	Alter, Rentenalter, Schulalter
edición	Auflage, Ausgabe
edificio	Hochhaus, Bauwerk, Bau, Reaktorgebäude, Bürogebäude, Gebäude
educación	Erziehung, Bildung, Grundbildung, Erwachsenenbildung, Sondererziehung, Sonderpädagogik, Sportunterricht, Sport, Vorschulerziehung, Ausbildung
educativa	
educativo	Bildungs-
ee	
efe	
efecto	Nebeneffekt, Corioliskraft, Effekt, Treibhauseffekt, Rückwirkung, Nebeneffekt, Nebenwirkung, Wirkung
efectos	Nebeneffekt, Corioliskraft, Effekt, Treibhauseffekt, Rückwirkung, Nebeneffekt, Nebenwirkung, Wirkung
eh	
ejecución	Ausführung, Schuldvollstreckung, Urteilsvollstreckung, Vollstreckung  eines Urteils, Durchführung, Exekution, Zwangsvollstreckung, Testamentsvollstreckung, Vollstreckung, Hinrichtung
ejecutivo	Exekutive, Manager
ejemplo	Beispiel
ejercicio	Aufgabe, Militärübung, Übung
ejército	Armee, himmlischen Heerscharen, Heer
el	das Ereignis des Jahres, nächstes Jahr, nächstes Jahr, im Jahr darauf, im nächsten Jahr, nächstes Jahr, der abgesetzte König, der, der Heilige Geist, derselbe, alter Wein  in neuen Schläuchen, letztens, neulich, der erste Mai, zueinander, X Prozent
elaboración	Herstellung
elecciones	Parlamentswahlen, Präsidentenwahl, Wahlen
elección	Kommunalwahl, Wahl
electrónico	elektronisch
elegido	gewählt
elementos	Bestandteil, Einzelteil, Element
ella	sie
ellas	sie, sie
ello	
ellos	sie
email	
embargo	Beschlagnahme, Embargo
emergencia	Notfall
empezar	anfangen, beginnen, beginnen etw. zu tun, etw. einleiten
empezó	
empieza	
empleados	Angestellter, Arbeitnehmer
empleo	Beschäftigung, Arbeitsstelle
empresa	Energieversorgungsunternehmen  , Landwirtschaftsbetrieb, Betrieb, Briefkastenfirma, Luftfahrtgesellschaft, Dienstleistungsunternehmen, Ausfuhrfirma, Ausfuhrunternehmen, Exportunternehmen, Familienunternehmen, Firma, Tourismusbetrieb, Unternehmen, Werk
empresarial	betrieblich
empresarios	Intendant, Unternehmer
empresas	Energieversorgungsunternehmen  , Landwirtschaftsbetrieb, Betrieb, Briefkastenfirma, Luftfahrtgesellschaft, Dienstleistungsunternehmen, Ausfuhrfirma, Ausfuhrunternehmen, Exportunternehmen, Familienunternehmen, Firma, Tourismusbetrieb, Unternehmen, Werk
en	in, auf, an, über
encanta	
encima	darauf, auf, oben, über
encontraba	
encontrado	herausgefunden
encontramos	
encontrar	jdm. begegnen, jdn./etw. finden, jdn./etw. treffen, etw. an Land ziehen
encontrarás	
encontré	
encuentra	
encuentran	
encuentro	Begegnung, Treffen
energía	Atomenergie, Bewegungsenergie, kinetische Energie, Bindungsenergie, Energie, Windenergie, Atomenergie, Lageenergie, potenzielle Energie, Fotovoltaik, Photovoltaik, Sonnenenergie, Solarthermie, Solarthermie, Wärmeenergie
enero	Januar  
enfermedad	Herzkrankheit, Geschlechtskrankheit, Erbkrankheit, Infektionskrankheit, Itai-Itai-Krankheit, Krankheit, Stoffwechselerkrankung, Stoffwechselkrankheit, Nervenkrankheit, Geschlechtskrankheit, Viruskrankheit, Erkrankung
enfermedades	
enfrentar	sich  etw.  gegenübersehen
enseñanza	Sekundarstufe, Unterricht
ente	Wesen
entender	jdn./etw. verstehen, etw. begreifen
entidad	Unternehmen
entidades	
entiendes	
entiendo	
entonces	also, dann, damals
entorno	Umgebung
entra	
entrada	Anzahlung, Einfahrt, Einlass, Einmarsch, Eintrittskarte, Strömungsabriss, Inkrafttreten, Haupteingang, Ticket, Vorgericht, Vorspeise, Zufahrt, Eintrag, Einreise, Eingang, Eintritt
entradas	Geheimratsecken, Vorspeisen, Anzahlung, Einfahrt, Einlass, Einmarsch, Eintrittskarte, Strömungsabriss, Inkrafttreten, Haupteingang, Ticket, Vorgericht, Vorspeise, Zufahrt, Eintrag, Einreise, Eingang, Eintritt
entrar	einbrechen, eindringen, einloggen, zum Einsatz kommen, zur Tat schreiten, in etw.  hineingehen, sich in etw. einloggen, mit jdm. Kontakt aufnehmen, in Kraft treten, hereinkommen
entre	bei, in Anführungszeichen, dazwischen, dividiert durch, geteilt durch, während, zwischen
entrega	Schlüsselübergabe, Lieferung, Zustellung, Anlieferung
entrenamiento	Training, Übung
entrevista	Vorstellungsgespräch, Interview, Bewerbungsgespräch
enviar	jdn./etw. entsenden, etw. schicken, etw. senden, etw. verschicken
envigado	
episodio	Episode, Folge
eps	
equipo	Feuerwehrausstattung, Fußballmannschaft, Kamerateam, Musikanlage, Filmteam, Rettungsausstattung, Rettungsmannschaft, Mannschaft, chirurgische Ausstattung, Team, Ausrüstung, Ausstattung
equipos	Feuerwehrausstattung, Fußballmannschaft, Kamerateam, Musikanlage, Filmteam, Rettungsausstattung, Rettungsmannschaft, Mannschaft, chirurgische Ausstattung, Team, Ausrüstung, Ausstattung
era	Atomzeitalter, Tenne, Ära
eran	
eras	Atomzeitalter, Tenne, Ära
eres	
errores	
es	es ist wichtig, dass, es ist das Beste, etw. zu machen, es ist wahrscheinlich, dass, nämlich, so geizig sein, dass..., und 
esa	
esas	
escolar	Schul-
escribir	schreiben, Briefe schreiben
escribió	
escrito	großgeschrieben, kleingeschrieben, schriftlich, Schreiben
escucha	
escuela	Grundschule, Berufsschule, Sprachschule, Berufsschule, Sonntagsschule, Grundschule, Schule, Fachhochschule  
ese	der da, dieser, jener, dieser, an diesem Tag, an jenem Tag, jener
esfuerzo	Anstrengung, Bemühung, Einsatz
esfuerzos	Anstrengung, Bemühung, Einsatz
eso	das, dies, jener
esos	jene
espacio	Luftraum, euklidischer Raum, Weltraum, metrischer Raum, Ort, Raum, Weltraum, topologischer Raum, linearer Raum, Vektorraum, Weltraum, Pause, Nutzraum
espacios	Luftraum, euklidischer Raum, Weltraum, metrischer Raum, Ort, Raum, Weltraum, topologischer Raum, linearer Raum, Vektorraum, Weltraum, Pause, Nutzraum
españa	
español	spanisch, Rioplatensisch, Río-de-la-Plata-Spanisch, Spanier, Spanisch
española	Spanierin
especial	besonders, Spezial-, speziell
especiales	
especialista	Fachfrau, Fachärztin, Wirtschaftsexperte, Facharzt, Fachmann, Sachverständiger, Spezialist, Stuntman
especialmente	besonders, vor allem
especie	Lemurenart, Gewürz, Spezies
especies	vom Aussterben bedrohte Arten, Lemurenart, Gewürz, Spezies
espectacular	aufsehenerregend, spektakulär
espera	
esperaba	
esperando	erwartend
esperar	auf jdn./etw. warten, jdn./etw. erwarten, sich auf etw. freuen, etw. von jdm. erwarten, etw. hoffen, eine Antwort erwarten, ein Baby / Kind erwarten, warten
espere	
esperen	
espero	
esposa	Ehefrau
esta	heute Morgen, heute Abend, heute Nacht, diesmal
estaba	
estaban	
estabas	
establece	
establecer	etw. bestimmen, etw. gründen
establecido	festgelegt
establecidos	
establecimiento	Gründung
estación	Bahnhof, Hauptbahnhof, Busbahnhof, Schigebiet, Skigebiet, Bahnhof, Jahreszeit, Kläranlage, Tankstelle, Bahnhof, Raumstation, Bahnhof, Jahreszeit, Station, Endstation, Haltestelle
estadio	Fußballstadion, Olympiastadion, Stadion, Stadium
estado	Familienstand, Kontostand, Alarmzustand, Alarmzustand, Bewusstseinszustand, Ausnahmezustand, Belagerungszustand, Bundesland, Lage, Mitgliedsstaat, Polizeistaat, Staat, Stand, Zustand
estados	Familienstand, Kontostand, Alarmzustand, Alarmzustand, Bewusstseinszustand, Ausnahmezustand, Belagerungszustand, Bundesland, Lage, Mitgliedsstaat, Polizeistaat, Staat, Stand, Zustand
estados unidos	
estadounidense	amerikanisch, US-amerikanisch, US-Amerikanerin, Amerikaner, US-Amerikaner
estamos	
estan	
estar	sein
estaremos	
estará	
estarán	
estarás	
estaré	
estaría	
estas	heute Morgen, heute Abend, heute Nacht, diesmal
este	dieser, dieses Jahr, heuer, dieser, Osten  
estilo	Kolonialstil, direkte Rede, Griffel, indirekte Rede, Look, Schmetterlingsstil, Stil, Füller, Füllfederhalter
esto	das hier, das, dies
estos	diese, diese sind
estoy	
estrategia	Strategie
estrategias	Strategie
estrellas	Seestern, Doppelstern, Fixstern, Sternschnuppe, Polarstern, Stern, Star
estructura	algebraische Struktur, Atomstruktur, Aufbau, Bauart, Zellstruktur, Datenstruktur, Unternehmensstruktur, Verzeichnisstruktur, Produktionskostenstruktur, Programmstruktur, Mikroprozessoraufbau, Baumstruktur, nationale Wirtschaftsstruktur, Gliederung, Anordnung, Gefüge, Struktur
estudiante	Spanischlernende, Schülerin, Studentin, Studierende, Spanischlernender, Austauschstudent, Schüler, Student, Studierender
estudiantes	Spanischlernende, Schülerin, Studentin, Studierende, Spanischlernender, Austauschstudent, Schüler, Student, Studierender
estudiar	studieren, etw. lernen, Spanisch lernen
estudio	Feldstudie, Studium, Arbeitszimmer, Atelier, Studio, Studie, Dachwohnung
estudios	Diplomstudiengang, Magisterstudiengang, Studium, Feldstudie, Studium, Arbeitszimmer, Atelier, Studio, Studie, Dachwohnung
estuve	
estuviera	
estuviste	
estuvo	
está	es steht einwandfrei fest, dass...
estábamos	
están	
estás	es steht einwandfrei fest, dass...
esté	
estén	
estés	
etapa	Etappe
europa	
evaluación	Auswertung, Risikobewertung, Evaluierung, Einschätzung
evento	Ereignis, gesellschaftliches Ereignis, Veranstaltung
eventos	Ereignis, gesellschaftliches Ereignis, Veranstaltung
evitar	jdm./etw. ausweichen, jdn./etw. meiden, etw. verhindern, etw. vermeiden
ex	Exfreundin
exactamente	genau
examen	Sehtest, Staatsexamen, Untersuchung, Klausur, Prüfung, Test
excelente	ausgezeichnet, exzellent, herausragend, hervorragend, super
excelentes	
excepto	abgesehen von, ausgenommen, außer
existe	
existen	
existencia	Existenz
expediente	Akte
experiencia	Erfahrung, Berufserfahrung
experiencias	Erfahrung, Berufserfahrung
expires	
explica	
explicó	
expresión	Redensart, Ausdruck
expresó	
exterior	auswärtig, äußere
extraño	eigentümlich, fremd, merkwürdig, seltsam, sonderbar, Fremder
fabio	
fabricación	Herstellung, Fabrikation
fabricante	Autohersteller, Automobilhersteller, Autohersteller, Automobilhersteller, Fabrikant, Hersteller
facebook	
factores	
facultad	Ermächtigung, Fakultät, Fähigkeit, Können, Begabung
fallo	Erdschluss, Fehler, menschliches Versagen, Multiorganversagen  , Organversagen, Urteil
falta	Unaufmerksamkeit, Mangel  an Verständnis, Skrupellosigkeit, Unvernunft, Untergewicht, Respektlosigkeit, Zeitmangel, Foul, Rechtschreibfehler, Fehler, Mangel
familia	Familie  , Gründerfamilie, Gastfamilie, angeheiratete Verwandte
familiar	Familien-, familiär, Verwandte
familiares	
familias	Familie  , Gründerfamilie, Gastfamilie, angeheiratete Verwandte
famoso	bewundert, bekannt, berühmt
farc	
fase	Endphase, Larvenstadium, Mondphase, Phase, Stufe, Übergangsphase
favor	Gefallen, Gunst
fe	Glaube
febrero	Februar  
fecha	Datum, Ablaufdatum, Haltbarkeitsdatum, Verfallsdatum, Rückgabedatum, Abgabetermin, Herstellungsdatum, Geburtsdatum, Stichtag, Termin, Stichtag
fechas	Datum, Ablaufdatum, Haltbarkeitsdatum, Verfallsdatum, Rückgabedatum, Abgabetermin, Herstellungsdatum, Geburtsdatum, Stichtag, Termin, Stichtag
felicidad	Seligkeit, Glück
feliz	glücklich, zufrieden
fernando	
festival	Festival, Fest
fiesta	Geburtstagsfeier, Geburtstagsparty, Oktoberfest, Johannisfeier, Familienfeier, Nationalfeiertag, Feier, Fest, Fete, Party, Feiertag, Festtag
figura	Tanzfigur, Figur
filosofía	Philosophie
fin	Beendigung, Weltuntergang, Spielende, Wochenende, Absicht, Zweck, Ziel, Ende, Schluss
final	Finale, Ende, Schluss
finales	
finalmente	endlich, letztendlich, schließlich, zuletzt
financiación	
financiera	
financiero	Finanz-, finanziell
finca	Grundstück, Landgut
fines	
firma	Unterschrift, Firma
fiscal	Fiskal-, fiskalisch, Steuer-, steuerlich, Staatsanwältin, Staatsanwalt
fiscalía	Staatsanwaltschaft
fondo	Boden, Pensionsfonds, Fonds, Geldmittel, Hintergrund, Meeresboden, Meeresgrund, Beckenboden, Untergrund, Grund
forma	Todesart, Form, Verbform
formación	Ausbildung, Produktschulung, Schulbildung, Berufsausbildung, Lehre, Schulung
formar	etw. bilden, etw. formen, zu jdm./etw. gehören, Teil von etw. sein, zu etw. gehören
formas	Todesart, Form, Verbform
formato	
formulario	Formular
fortalecer	jdn./etw. kräftigen
foto	Bild, Foto  ]
fotos	Bild, Foto  ]
francia	
francisco	
francés	französisch , Altfranzösisch, Franzose, Französisch
frecuencia	Frequenz, Atemfrequenz, Häufigkeit
frente	gegenüber, Stirn, Spritzschutz, Front
fri	
fue	
fuego	Brand, Feuer
fuente	Netzgerät, Netzteil, Datenquelle, Rechtsquelle, Energiequelle, Informationsquelle, Einnahmequelle, Jungbrunnen, historische Quelle, Auflaufform, Primärquelle, Schüssel, Springbrunnen, Brunnen, Quelle
fuentes	gut informierte Kreise, Schüsseln, Netzgerät, Netzteil, Datenquelle, Rechtsquelle, Energiequelle, Informationsquelle, Einnahmequelle, Jungbrunnen, historische Quelle, Auflaufform, Primärquelle, Schüssel, Springbrunnen, Brunnen, Quelle
fuera	ausgenommen, außerhalb von, außerhalb, außer, außer Gefecht gesetzt, gesetzwidrig, illegal, im Off-Line-Betrieb, unpassend, draußen, heraus, aus, Abseits
fueron	
fuerte	kräftig, satt, stark, Festung
fuerza	Luftwaffe, Zentripetalkraft, Corioliskraft, Juggernaut, Willenskraft, Kraft, Stärke
fuerzas	Luftwaffe, Zentripetalkraft, Corioliskraft, Juggernaut, Willenskraft, Kraft, Stärke
fui	
fuimos	
fuiste	
full	
funcionamiento	Funktionieren
funcionario	Beamter
funcionarios	Beamter
funciones	
función	Aufführung, Hirnfunktion, quadratische Funktion, Zustandsgröße, quadratische Funktion, Austrittsarbeit, Funktion, homogene Funktion, lineare Funktion, ganzrationale Funktion, Polynomfunktion, Vorstellung
fundación	Stiftung, Gründung
fundamental	grundlegend, wesentlich
fundamentales	
futuro	kommend, künftig, zukünftig, zusammengesetzte Zukunft, Zukunft
fácil	einfach zu merken, einfach, leicht
física	Atomphysik, Quantenphysik, Festkörperphysik, Teilchenphysik, Atomphysik, Kernphysik, Physik, Physikerin
físico	physikalisch, physisch, körperlich, Atomphysiker, Physiker
fútbol	Handball, Fußball
gabriel	
gaceta	
ganador	siegreich, Gewinner, Sieger
ganar	gewinnen, etw. verdienen, Geld verdienen
ganó	
garantizar	jdm. zusichern, dass, etw. garantieren
garantía	Garantie, Gewähr
garcía	
gas	Abgas, Gas, Lachgas, Tränengas, Edelgas, Giftgas
gasolina	Benzin, bleifreies Benzin
gastos	Nebenkosten, Ausgaben, laufende Kosten, fixe Kosten, Kosten, Militärausgaben, Ausgabe, Aufwand
generación	Energieerzeugung, Generation
general	allgemein, General
generales	
generalmente	allgemein, im Allgemeinen, üblicherweise
generar	etw. erzeugen
genial	genial, spitzenmäßig
gente	junge Leute, junge Menschen, Leute, alte Leute, alte Menschen, ältere Leute, ältere Menschen, Menschen, Volk
geografía	Erdkunde, Geografie, Geographie
gerente	Geschäftsführerin, Verwalterin, Leiterin, Geschäftsführer, Verwalter, Leiter
gestión	Amtsführung, Qualitätsmanagement  , Dateienverwaltung, Dateiverwaltung, Geschäftsführung
gira	Tournee, Rundfahrt
global	
gobernación	Regierung
gobernador	Gouverneur
gobierno	Übergangsregierung, Bundesregierung, Regierung, Marionettenregierung
goles	
google	
gracias	aufgrund von, aufgrund, dank, Anmut, Grazie
grado	Kältegrad, Siedepunkt, Gehalt, Grad, Stufe, Klasse
gran	Deutsche Dogge, Urknall, Grünes Blatt, starker Einfluss, Reichtum an
grande	groß
grandes	Kaufhaus
gratis	gratis, kostenfrei, kostenlos, umsonst, unentgeltlich
gratuito	grundlos, unbegründet, willkürlich, gratis, kostenfrei, kostenlos, unentgeltlich
grupo	abelsche Gruppe, Selbsthilfegruppe, Unternehmensgruppe, Arbeitsgruppe  , Notstromaggregat, Stromaggregat, funktionelle Gruppe, Gruppe, Jugendgruppe, Blutgruppe
grupos	abelsche Gruppe, Selbsthilfegruppe, Unternehmensgruppe, Arbeitsgruppe  , Notstromaggregat, Stromaggregat, funktionelle Gruppe, Gruppe, Jugendgruppe, Blutgruppe
guerra	Bürgerkrieg, Spanisch-Amerikanischer Krieg, Krieg, Weltkrieg, Dauerkrieg, Stammeskrieg
guillermo	
gusta	
gustan	
gustaría	
gustavo	
gusto	Geschmack, Vergnügen, Geschmackssinn
guía	Installationsleitfaden, Branchenadressbuch, Führerin, Reiseleiterin, Telefonbuch, Fremdenführerin, Reiseführer, Führer, Fremdenführer, Reiseleiter
género	Todesart, Femininum, Gattung, Genus, Geschlecht, grammatisches Geschlecht, Maskulinum, Neutrum, Genre, Ware
gómez	
ha	
haber	etw. tun müssen, einen Fehlpass gespielt haben, völlig aus der Übung sein, fertig sein, haben / sein
habilidades	
habitaciones	
habitación	Hotelzimmer, Doppelzimmer, Einzelzimmer, Privatzimmer, Zimmer
habitantes	Einwohner  pro Quadratkilometer, Einwohnerin, Einwohner
habla	
hablando	
hablar	etw. sprechen, jdn. sprechen, wie ein Wasserfall reden, telefonieren, reden, sprechen
hablas	
hablo	
habrá	
habría	
había	
habían	
habías	
hace	vor vierzehn Tagen, kürzlich, vor kurzem, vor Kurzem, vor einem Jahr, vor hundert Jahren, vor
hacemos	
hacen	
hacer	machen
hacerle	
hacerlo	
hacerte	
haces	vor vierzehn Tagen, kürzlich, vor kurzem, vor Kurzem, vor einem Jahr, vor hundert Jahren
hacia	herab, nach unten, nach vorn, hinüber, aufwärts, nach oben, nach hinten, rückwärts, himmelwärts, gegen acht, in Richtung Madrid, nach, auflandig
hacienda	Bauernhof, Farm, Landgut
haciendo	
hacía	
haga	
hagan	
hagas	
hago	mache
han	es sind Komplikationen aufgetreten
haremos	
hará	
haré	
haría	
has	
hasta	bisher, bis jetzt, bislang, bis, bis ans Ende der Welt, bisher, bis zum heutigen Tag, bis, sogar
hay	es gibt, es ist, es sind, man muss
haya	Amerikanische Buche, Kerb-Buche
hayan	
hayas	Amerikanische Buche, Kerb-Buche
haz	Elektronenstrahl, Protonenstrahl, Strahl
hazlo	
he	
hecho	handgearbeitet, handgefertigt, handgemacht, von Hand gemacht, von Menschenhand geschaffen, zerbrochen, zerbrochen, püriert, geschissen, beschissen, Fakt  ], Tatsache
hechos	handgearbeitet, handgefertigt, handgemacht, von Hand gemacht, von Menschenhand geschaffen, zerbrochen, zerbrochen, püriert, geschissen, beschissen, Fakt  ], Tatsache
hectáreas	Hektar   
hemos	
hermana	Schwester
hermano	Bruder, leiblicher Bruder, großer Bruder, kleiner Bruder
hermanos	Gebrüder, Geschwister, Bruder, leiblicher Bruder, großer Bruder, kleiner Bruder
herramienta	Werkzeug
herramientas	Rüstzeug, Werkzeug
hey	
hice	
hicieron	
hicimos	
hiciste	
hija	Tochter
hijo	Hundesohn, Hurensohn, Sohn, Einzelkind
hijos	Kinder, Söhne, Hundesohn, Hurensohn, Sohn, Einzelkind
historia	Krankengeschichte, Kunstgeschichte, Mediengeschichte, Erzählung, Entwicklungsgeschichte, Geschichte, Menschheitsgeschichte
historias	Krankengeschichte, Kunstgeschichte, Mediengeschichte, Erzählung, Entwicklungsgeschichte, Geschichte, Menschheitsgeschichte
histórica	
histórico	geschichtlich, historisch
hizo	hat ein Stück gemacht
hogar	Feuerstelle, Heim, Zuhause, Herd, Kamin
hoja	Klinge, Messerklinge, Blatt, Sägeblatt, Rasierklinge, Beipacktext, Lorbeerblatt, Zitronenmelisse, Blatt  Papier, Lohnzettel, Stichsägeblatt, Flügel
hola	
hombre	ein ganzer Mann, Farbiger, Geschäftsmann, Glückspilz, junger Mann, Froschmann, Mensch, Mann
hombres	ein ganzer Mann, Farbiger, Geschäftsmann, Glückspilz, junger Mann, Froschmann, Mensch, Mann
home	
honor	Ehre
hora	Essenszeit, Sprechstunde, Tageszeit, Uhrzeit, Flugstunde, Überstunde, Ortszeit, Stunde  , Uhrzeit
horas	Besuchszeiten, Stunden, Essenszeit, Sprechstunde, Tageszeit, Uhrzeit, Flugstunde, Überstunde, Ortszeit, Stunde  , Uhrzeit
hospital	Hospital, Klinikum, Klinik, Krankenhaus, Spital  ]
hotel	Luxushotel, Hotel
hoteles	
hoy	heutzutage, heute, Heute
hs	
hubiera	
hubo	es gab
huila	
humana	
humano	menschlich
humanos	
iba	
ibagué	
idea	Grundidee, Idee
ideal	ideal
ideas	Grundidee, Idee
identidad	Identität
identificación	Identifikation, Identifizierung
identificar	jdn./etw. identifizieren
ido	
iglesia	Gotteshaus, Kirche, Pfarrkirche
igual	gleich, genauso wie
igualmente	ebenfalls, gleichfalls
imagen	Bild, Image, Magnetresonanztomographie  , Satellitenbild, Spiegelbild
impacto	Umweltbelastung, Umweltbelastung, Stoß
implementación	Implementierung
importa	
importancia	Bedeutsamkeit, Wichtigkeit, Bedeutung
importante	bedeutend, bedeutsam, belangreich, belangvoll, wichtig, einflussreich
importantes	einflussreich
impuesto	Ökosteuer, Gemeindesteuer, Mehrwertsteuer  , Steuer
impuestos	Steuern, Ökosteuer, Gemeindesteuer, Mehrwertsteuer  , Steuer
imágenes	
in	
incluso	sogar
incluye	
incluyendo	
independiente	eigenständig, unabhängig, selbstständig, selbständig
indica	
indicó	
individuos	Individuum
industria	Rüstungsindustrie, Atomindustrie, Autoindustrie, Automobilindustrie, Kraftfahrzeugindustrie, Filmindustrie, Fleischverarbeitungsindustrie, Tourismusindustrie, herstellende Industrie, Industrie, Atomindustrie, Fischindustrie, fischverarbeitende Industrie, chemische Industrie, Textilindustrie
industrial	industriell
indígenas	eingeboren, Eingeborene, Eingeborener
infancia	Kindheit
influencia	Einfluss
información	Auskunft, Information
informe	unförmig, Angabe, Bericht
informes	Angabe, Bericht
informó	
infraestructura	Infrastruktur
ingeniero	Ingenieur  , Schiffbauingenieur
ingeniería	Umweltingenieurwesen  , Schiffbautechnik, Ingenieurwissenschaft
inglés	englisch , Englisch, Engländer
ingresa	
ingresar	etw. einzahlen, in etw.  eintreten, etw.  beitreten, ins Krankenhaus eingewiesen / aufgenommen werden, einbezahlen
ingreso	Einkommen, Einnahme, Aufnahme
ingresos	Einkommen, Einkünfte, Steuereinnahmen, Einkommen, Einnahme, Aufnahme
iniciar	etw. aufnehmen, etw. beginnen, etw. booten
iniciativa	Initiative
inicio	Beginn
inició	
inmediato	augenblicklich, umgehend, unmittelbar, unverzüglich
inmuebles	Immobilien
inn	
innovación	
instalaciones	
instancia	
institucional	
instituciones	
institución	Einrichtung, Institution, öffentliche Einrichtung
instituto	Fachoberschule, Sprachinstitut, Institut, Gymnasium, Schule
integración	Integration
integral	Vollkorn-, Integral
intento	Ausbruchsversuch, Fluchtversuch, Selbstmordversuch, Versuch
interesadas	Interessentin
interesados	egoistisch, voreingenommen, interessiert, Interessent
interesante	interessant
intereses	
interior	innere, Landesinnere
internacional	international
internacionales	
internet	Internet
interno	innere, intern
interpretación	Auswertung, Interpretation
intervención	Eingriff, Intervention
interés	Zinseszins, Gewinn, Interesse, öffentliches Interesse, Wucherzins, Zinsen, Zinssatz, Zins
inversión	Anlage, Kapitalanlage, Investition, Kapitalanlage
investigación	Grundlagenforschung, Ermittlung, Forschung, Untersuchung
investigadores	
invitados	Stargast, Gast
ir	gehen
iremos	wir gehen
irme	
irá	
iré	
isla	Karibikinsel, Eiland, Insel, Vulkaninsel
israel	
italia	
jaime	
james	
jamás	jemals, nie, niemals
jefe	Chef, Staatschef, Bauleiter, Produktionsleiter, Empfangschef, Vertriebsleiter, Leiter, Vorgesetzter
jornada	Arbeitstag, Arbeitszeit, Arbeitszeit, Tagesreise
joven	jugendlich, jung, Jugendliche, junge Frau, Jugendlicher, junger Mann
juan	
judicial	gerichtlich
juego	Glücksspiel, Steuersatz, Elektrodensatz, Computerspiel, Wortspiel, Beinarbeit, Pfänderspiel, Kaminbesteck, Spiel, Satz, Set  ]
juegos	Glücksspiel, Steuersatz, Elektrodensatz, Computerspiel, Wortspiel, Beinarbeit, Pfänderspiel, Kaminbesteck, Spiel, Satz, Set  ]
jueves	Donnerstag  
juez	Richterin, Richter
jugador	Basketballer, Basketballspieler, Fußballer, Fußballspieler, Eishockeyspieler, Spieler
jugadores	
jugar	spielen, Ball spielen, Karten spielen, Fußball spielen, bowlen, Bowling spielen, würfeln, Tennis spielen, online spielen, eine Rolle spielen
juicio	Gottesurteil, Gerichtsverhandlung, Urteilsfähigkeit, Urteilskraft, Ermessen, Meinung, Urteil, Prozess, Vernunft, Verstand
julio	Joule, Juli, vergangener Juli
junio	Juni
junta	Ausschuss, Zylinderkopfdichtung, Brennerdichtung, Dichtung, Vorstand, Fuge, Militärjunta, Sitzung, Verbindungsstelle, Verbindung, Versammlung, Treffen
junto	an, bei, neben, mit, gemeinsam, miteinander, zusammen 
juntos	an, bei, neben, mit, gemeinsam, zusammen
juro	
jurídica	
jurídicas	
justicia	Gerechtigkeit, Justiz, Recht
justo	gerade, genau, gerecht
juzgado	Handelsgericht, Gericht
jóvenes	Jugendliche
kilómetros	Kilometer
la	das, der, sehr, viel, meistens, das nächste Mal, die kommende Woche, die, es, sie, A
la primera	
labor	Arbeit
laboral	Arbeits-, beruflich
labores	
lado	Seite, Oberseite
lamento	
lanzado	
lanzamiento	Abschuss, Diskuswerfen, Hammerwerfen, Münzwurf, Kugelstoßen, Einführung  eines Produktes, Werfen, Wurf, Markteinführung
larga	
largo	lang, langwierig, Länge
las	sehr, viel, meistens, das nächste Mal, die schönen Künste, welche, Viertel nach zehn, halb elf, beide, die beiden, die zwei, die kommende Woche, die Fallas, Viertel vor elf, sehr spät, die, die, es, sie, A
latina	Lateinamerikanerin, Latina, Latinerin
le	ihn, Ihnen, ihm, ihr
lectura	Lektüre, Pflichtlektüre
leer	lesen, vorlesen
legal	gesetzlich, legal, rechtlich, rechtmäßig
legales	
legislación	Gesetzgebung
lejos	entfernt von, weit von, entfernt, weit, weit
lenguaje	Umgangssprache, Körpersprache, Programmiersprache, Umgangssprache, Sprache  , Vulgärsprache
les	ihnen, Ihnen, ihm, ihr
ley	Erbgesetz, Gesetz, Strafvollzugsgesetz
leyes	
león	Asiatischer Löwe, Indischer Löwe, Persischer Löwe, Atlaslöwe, Berberlöwe, Nubischer Löwe, Atlaslöwe, Berberlöwe, Nubischer Löwe, Kaplöwe, Seelöwe, Löwe
libertad	Bewährung, Gewissensfreiheit, Meinungsfreiheit, Meinungsfreiheit, Pressefreiheit, Versammlungsfreiheit, Freiheit
libre	freier Wettbewerb, gebührenfrei, frei
libro	Buch, Bildband, Kochbuch, Bilderbuch, Arbeitsbuch, Kochbuch, Arbeitsbuch
libros	Buch, Bildband, Kochbuch, Bilderbuch, Arbeitsbuch, Kochbuch, Arbeitsbuch
licencia	Waffenschein, Führerschein, Führerschein, Baugenehmigung, Fischereilizenz, Genehmigung, Lizenz, dichterische Freiheit
liderazgo	
liga	Fußballliga, Strumpfband, Vogelleim
limpieza	Gesichtsbehandlung, Sauberkeit, Putzen, Reinigen
linda	
lindo	bildhübsch, bildschön, hübsch, nett, schön, süß, wunderschön, niedlich
lista	Einkaufsliste, Einkaufszettel, Speisekarte, Preisliste, Wahlliste, Wählerliste, Liste
listo	bereit, fertig, intelligent, klug
listos	bereit, fertig, intelligent, klug
literatura	Literatur
llama	Flamme, Lama
llamada	Telefonat, R-Gespräch, entgangener Anruf, verpasster Anruf, Telefonanruf, Ortsgespräch
llamado	sogenannt 
llaman	
llamar	anrufen, rufen, telefonieren, jdn. zum Militärdienst einberufen, jdn. nennen, etw. schmecken, die Aufmerksamkeit auf sich ziehen, telefonieren, klingeln, läuten
llegada	Ankunft  , Ziel
llegado	
llegar	in den Hafen einlaufen, ankommen, etw. erfahren, zur rechten Zeit ankommen, sich einigen, zu einer Einigung kommen, kommen, sich verspäten, unpünktlich sein, erreichen
llegó	
lleva	
llevado	
llevar	jdm. widersprechen, etw. ausführen, etw. beenden, etw. bewerkstelligen, etw. bewältigen, etw. durchführen, etw. erledigen, etw. fertig bringen, etw. fertigstellen, etw. machen, etw. vollbringen, etw. vollenden, etw. zustande bringen, etw. im Blut haben, etw. bringen, etw. hinbringen, etw. mitbringen, etw. führen, etw. tragen, etw. tragen, etw. mit sich führen, etw. mit sich herumtragen, jdn. abführen, frankiert sein, jdm. widersprechen, etw. anhaben, angeschnallt sein
llevas	
llevo	
llevó	
lo	so bald wie möglich, das Übliche, dasselbe, das Wichtigste, das Außergewöhnliche, dasselbe, das, was, was auch immer, was du willst, als nächstes, das Übliche, es, ihn, sie, das Einzige
local	lokal, Raum, Lokal, örtlich
locales	
localidad	Ortschaft, Ort
loco	verrückt, wahnsinnig, Verrückter, Wahnsinniger, Alter
lograr	etw. erlangen, etw. erreichen
logró	
londres	
longitud	Schwanzlänge, Wellenlänge, Länge
los	so bald wie möglich, das Übliche, dasselbe, das Wichtigste, das Außergewöhnliche, dasselbe, das, was, was auch immer, was du willst, die Anderen, die Übrigen, die Zehn Gebote, sonntags, beide, die beiden, die zwei, an Wochentagen, an Wochenenden, als nächstes, donnerstags, montags, dienstags, mittwochs, San-Fermin-Fest, samstags, sonnabends, freitags, die, Obdachlose, das Übliche, es, ihn, sie, das Einzige
ltda	
lucha	Kampf, Arbeitskampf, Ringkampf
luego	dann, folglich, nachdem, nachher, später
lugar	Treffpunkt, Sehenswürdigkeit, Unfallort, Tatort, Unfallort, Unglücksort, Geburtsort, Herkunftsort, Wohnort, Wohnsitz, Treffpunkt, Arbeitsplatz, Lieblingsplatz, Lage, Ort, Platz, Raum, Stelle
lugares	
luis	
lujo	Luxus
luna	Flitterwochen, Vollmond, Mond, Neumond
lunes	Montag  
luz	Nebelschlussleuchte, Abblendlicht, Zwielicht, Mondlicht, Mondschein, Fernlicht, Abblendlicht, Standlicht, Bremslicht, Leselampe, Sonnenschein, Rückfahrscheinwerfer, Neonlicht, Fernlicht, Licht, Mondlicht, Sonnenlicht, Rücklicht, Strom
líder	Anführerin, Führerin, Anführer, Führer
línea	Fluggesellschaft, Fluglinie, Digital Subscriber Line  , Hochspannungsleitung, Auslinie, Wasserlinie, Ziellinie, Lackierstraße, Bahnlinie, Seitenlinienorgan, Leitung, Linie, Luftlinie, Zeile
líneas	Fluggesellschaft, Fluglinie, Digital Subscriber Line  , Hochspannungsleitung, Auslinie, Wasserlinie, Ziellinie, Lackierstraße, Bahnlinie, Seitenlinienorgan, Leitung, Linie, Luftlinie, Zeile
lópez	
m	
madera	Eichenholz, Holz, Edelholz
madre	Mutter, Alleinerziehende
madres	Mutter, Alleinerziehende
madrid	
maestro	Grundschullehrer, Lehrer, Braumeister, Baumeister, Meister
magdalena	Biskuittörtchen, Madeleine
mal	Mundgeruch, böse, elend, falsch, fehlerhaft, zusammenhangslos, hässlich, schlecht aussehend, schlecht, Böse, Liebeskummer, Krankheit
mala	Unglück, Fehlkauf, schlechte Erziehung, Unkraut, schlechter Ruf, Pech, Pech
maldición	Fluch
maldita	
maldito	verdammt, verflixt, verflucht
malo	böse, gemein, schlecht, schlimm, krank, boshaft, unartig, ungezogen
mamá	Mama
mandatario	
mando	Fernbedienung, Herrschaft, Kommando, Macht
manejo	Umgang
manera	Art, Manier, Weise
manifestó	
manifiesta	
manizales	
mano	Stößel, Arbeitskraft, Hand, Schicht, Typ
manos	Hände, Stößel, Arbeitskraft, Hand, Schicht, Typ
mantener	jdn./etw. versorgen, etw. behalten, etw. erhalten, etw. unterhalten, etw. warten, sich Briefe schreiben, eine Freundschaft unterhalten, eine Maschine warten, ein Geschäft unterhalten
mantenimiento	Aufrechterhaltung, Wartung
mantuvo	
manuel	
maquinaria	Maschinerie, Maschinenpark
mar	ablandig, Tiefsee, Irische See, Flammenmeer, Marmarameer, Tiefsee, Meer, See
marca	Eigenmarke, Markenzeichen, Wasserzeichen, Eigenmarke, Eigenmarke, Marke, Eigenmarke, Markenzeichen, Rekord
marcas	Eigenmarke, Markenzeichen, Wasserzeichen, Eigenmarke, Eigenmarke, Marke, Eigenmarke, Markenzeichen, Rekord
marcha	Vormarsch, Rückwärtsgang, Eilmarsch, Trauermarsch, Gang, Marsch, Hochzeitsmarsch
marco	Deutsche Mark  , Türrahmen, Fensterrahmen, Bilderrahmen
marido	Ehemann
mario	
marta	Baummarder, Baummarder, Marder
martes	Dienstag  
marzo	März  
maría	
mas	sondern, aber, jedoch
masajes	Fußreflexzonenmassage, Gesichtsmassage, Massage, Dammmassage
matar	jdn./etw. töten, jdn./etw. umbringen, den Hunger stillen, den Durst stillen
materia	Unterrichtsstoff, Rohstoff, Stoff, Substanz
material	Baumaterial, Genmaterial, belastendes Material, Informationsmaterial, Material
materiales	
materias	Unterrichtsstoff, Rohstoff, Stoff, Substanz
matrimonio	Eheleute, Ehepaar, Ehe, Heirat
mató	
may	
mayo	Mai
mayor	volljährig, größer, Übergewicht, Maximalgebot, älter, alt, Älteste, Ältester
mayores	
mayoría	Großteil, absolute Mehrheit, Aktienmehrheit, Mündigkeit, Volljährigkeit, Stimmenmehrheit, Mehrheit, einfache Mehrheit, relative Mehrheit, schweigende Mehrheit
mazda	
mañana	morgen, morgen früh, Morgen, Vormittag
me	ich habe Lust, etw. zu tun, es ekelt mich, gefällt mir, ich mag, mir gefällt ... besser, ich brauche, mich, mir
mecanismos	Uhrwerk, Mechanismus
medellin	
medellín	
media	Halbschwester, Halbmond, arithmetisches Mittel, Strumpf, Socke, Durchschnitt
mediados	
mediante	durch, mittels
medicina	Intensivmedizin, Medizin, Nuklearmedizin, Tropenmedizin
medida	Maßregel  der Besserung und Sicherung, Maßregel  der Besserung und Sicherung, Sicherheitsvorkehrung, Disziplinarmaßnahme, Maß, Maßnahme, Maßregel  der Besserung und Sicherung
medidas	Maßregel  der Besserung und Sicherung, Maßregel  der Besserung und Sicherung, Sicherheitsvorkehrung, Disziplinarmaßnahme, Maß, Maßnahme, Maßregel  der Besserung und Sicherung
medio	halb, medium, Halbbruder, ein halbes Kilo ..., feste Masche, Halbzeit, durchschnittlich, Umwelt, Kommunikationsmittel, Spannmittel, Transportmittel, Verkehrsmittel, Mitte, Mittel
medios	medium, Halbbruder, ein halbes Kilo ..., feste Masche, Massenmedien, Halbzeit, durchschnittlich, Umwelt, Kommunikationsmittel, Spannmittel, Transportmittel, Verkehrsmittel, Mitte, Mittel
mejor	besser
mejorar	etw. verbessern, genesen, gesund werden
mejores	
memoria	Direktzugriffsspeicher, Erinnerung, Speicher, USB-Stick, Erinnerungsvermögen, Gedächtnis
mencionado	
menor	minderjährig, geringer, kleiner, jünger, geringste, kleinste, Jüngste, Jüngster
menores	
menos	abzüglich, weniger als 90 Kilometer, weniger kalt als, weniger, Minuszeichen, Minus
mensaje	Botschaft, SMS, Mitteilung, Nachricht
mensuales	
mente	Geist, Verstand
menudo	klein, Kleingeld
mercado	Baumarkt, Rohstoffmarkt, Weihnachtsmarkt, Arbeitsmarkt, aufstrebender Markt, Schwellenmarkt, Wachstumsmarkt, Binnenmarkt, Arbeitsmarkt, Markt, Geldmarkt, Schwarzmarkt, Wochenmarkt
mercados	Baumarkt, Rohstoffmarkt, Weihnachtsmarkt, Arbeitsmarkt, aufstrebender Markt, Schwellenmarkt, Wachstumsmarkt, Binnenmarkt, Arbeitsmarkt, Markt, Geldmarkt, Schwarzmarkt, Wochenmarkt
mes	ich habe Lust, etw. zu tun, es ekelt mich, gefällt mir, ich mag, mir gefällt ... besser, ich brauche, Sommermonat, Monat   in Bayern, Österreich]
mesa	Campingtisch, Esstisch, Wohnzimmertisch, Tischtennisplatte, Rollwagen, Büfett, Tisch
meses	
meta	Ziel
metas	Ziel
metodología	
metros	Zollstock, Meter   , Zollstock, Zollstock
mi	meine Liebe, mein, meine Welt deine Welt, E
miedo	Todesangst, Höhenangst, Lampenfieber, Angst, Lampenfieber, Furcht
miembro	Glied, Glied, Körperteil, Mitglied, Extremität, Bauteil
miembros	Glied, Glied, Körperteil, Mitglied, Extremität, Bauteil
mientras	während, wohingegen, in der Zwischenzeit, inzwischen, währenddessen, solange
mierda	Dreck, Scheiße
miguel	
mil	Milliarde  , tausend
miles	
militar	Militär-, militärisch, Militär, Soldat
militares	
millones	
ministerio	Ministerium, Staatsanwaltschaft, Aufgabe
ministro	Außenminister, Verteidigungsminister, Minister
minube	
minuto	Minute  , Schweigeminute
minutos	Minute  , Schweigeminute
mira	Korn, Zielfernrohr, Ziel, Visier
mirada	Blick
mire	
miren	
mis	meine Liebe, meine Welt deine Welt, E
misión	Einsatz, Missionsort, Mission
misma	
mismas	
mismo	selbe
mismos	
mitad	halb, Hälfte, Mitte
miércoles	Mittwoch  
moda	Herrenmode, Mode
modalidad	Art
modelo	Mannequin, Modell
modelos	Mannequin, Modell
modifica	
modo	Art, Verhaltensweise, Flugzeugmodus, Betriebsart, Vorgehensweise, Konjunktiv, Tonart, Weise
momento	Drehimpuls, Drehmoment, Biegemoment, Moment, Moment, Augenblick
momentos	Drehimpuls, Drehmoment, Biegemoment, Moment, Moment, Augenblick
mon	
montón	Haufen, Masse
morir	ertrinken, sterben, eingehen
mostrando	
motivo	Grund, Hauptgrund, Anlass
motivos	Grund, Hauptgrund, Anlass
motor	Anlasser, Suchmaschine, Verbrennungsmotor, Viertaktmotor, Zweitaktmotor, Dieselmotor, Elektromotor, Außenbordmotor, Motor
movimiento	Bewegung, Umweltschutzbewegung, Wellenbewegung, Friedensbewegung, Planetenbewegung, Satz
mucha	viele Leute
muchachos	Junge
muchas	viele Leute, oft
mucho	viel weniger, viel mehr, sehr, viel
muchos	viel weniger, viel mehr, viele
muerte	Erschießungstod, Hirntod, Waldsterben, Hirntod, nichtnatürlicher Tod, Tod
muerto	tot, Toter
muestra	Warenmuster, Stichprobe
mujer	Putzfrau, Geschäftsfrau, Frau, junge Frau, Prostituierte, Ehefrau
mujeres	Frauen
mundial	Welt-, Weltmeisterschaft
mundo	Unterwelt, Geschäftswelt, Arbeitswelt, Welt
municipal	Gemeinde-, Stadt-, städtisch
municipio	Gemeinde
municipios	Gemeinde
murió	
museo	Kunstmuseum, Museum
musical	musikalisch, Musical
muy	hoch geschätzt, sehr gut, ganz in der Nähe, potthässlich, gut durchgebraten, blutjung, sehr, uralt
más	eher ... als, weiter unten, gütiger, älteste, eher, vielmehr, mehr als, langsamer, potthässlich, ferner, fit wie ein Turnschuh, größer, größte, meistgesprochen, jünger, mehr, einigermaßen, mehr oder weniger, schätzungsweise, mehr als, wie nie zuvor, nachträglich, später, Jenseits, Pluszeichen, Plus
máxima	Grundsatz
máximo	größter
médico	Arzt, Hausarzt, Kassenarzt, Notarzt, Facharzt, Gerichtsmediziner, Leichenbeschauer, Naturheilkundler, Naturheilpraktiker, Landarzt
método	Rechenweg, Verhörmethode, Simpsonregel, simpsonsche Regel, Methode, Verfahren, System
métodos	Rechenweg, Verhörmethode, Simpsonregel, simpsonsche Regel, Methode, Verfahren, System
méxico	
mí	
mínima	
mínimo	geringster, mindestens
mío	
música	klassische Musik, Hintergrundmusik, Volksmusik, Musik, Rapmusik, Musikerin
nacional	Landes-, national, staatlich, heimisch
nacionales	
nació	
nación	Nation, Volk
nada	kaum angekommen, kaum, nichts mehr, nichts, nichts dergleichen, nichts derlei, Nichts, überhaupt nicht
nadie	niemand
nariño	
natural	natürlich
naturales	
naturaleza	Natur, Wesen
nave	Raumschiff, Fabrikhalle, Industriehalle, Werkhalle, Seitenschiff, Schiff
necesario	erforderlich, notwendig, nötig
necesarios	
necesidad	Bedürfnis, Notwendigkeit
necesidades	
necesita	
necesitamos	
necesitan	
necesitas	
necesito	
negocio	Angelegenheit, Beschäftigung, Betrieb, Geschäft, Laden
negocios	Geschäfte, Angelegenheit, Beschäftigung, Betrieb, Geschäft, Laden
negro	kohlrabenschwarz, pechschwarz, schwarz, dunkelhäutig
neiva	
new	
nexolocal	
ni	weder ... noch, auch nicht, auf keinen Fall, einigermaßen, keine Ahnung, geschweige denn ..., nicht mehr und nicht weniger, keine Ahnung, keinen blassen Schimmer, nicht den blassesten Schimmer, nicht einmal, nicht einmal
ninguna	
ninguno	keine, keiner, kein
ningún	kein
nivel	Wasserwaage, Meeresspiegel, Lebensstandard, Ebene, Niveau, Stufe
niveles	
niña	Mädchen, Mädel, Pupille
niñas	Mädchen, Mädchen, Mädel, Pupille
niño	Säugling, Jesuskind, Kind, Wunderkind, Junge
niños	Kinder, Säugling, Jesuskind, Kind, Wunderkind, Junge
no	Einzel-, etw. verfehlen, sich seiner Sache sicher sein, anders als, verfehlen, umweltfreundlich, keinen Handschlag tun, ergebnislos bleiben, nicht dürfen, den Mund nicht aufmachen, rede keinen Blödsinn, gönnen, halb so schlimm, nicht ganz bei Trost sein, nicht recht bei Trost sein, keine rechte Lust haben, unästhetisch, unformatiert, Nichtraucherin, Nichtraucher  , erst nächste Woche, jdm. nicht das Wasser reichen können, ... habe ich nicht mehr, in Kürze, höchstens, ungeboren, Ungeborenes, nein, nicht, etw. versäumen, nichtsdestotrotz, trotzdem, nicht aufhören etw. zu tun, bei etw. durchfallen, ungebeten, kein Auge zu bekommen, es nicht fassen können, einen Rochus auf jdn. haben, jdm. spinnefeind sein, jdn. auf den Tod nicht ausstehen können, jdn. nicht ausstehen können, jdn. nicht riechen können, etw. weglassen, ungebeten, nicht nur, nicht nur, dass ..., ins Wasser fallen, kein Blatt vor den Mund nehmen, reden, wie einem der Schnabel gewachsen ist, nicht auf den Kopf gefallen sein, an Realitätsverlust leiden
no. n	
noche	Freitagabend, Nacht
noches	Freitagabend, Nacht
nombrado	
nombre	Künstlername, Taufname, Vorname, Name, Nomen, Papstname, Eigenname, Vorname
norma	Regel
normal	normal
normas	Regel
norte	Norden  
nos	Einzel-, etw. verfehlen, sich seiner Sache sicher sein, anders als, verfehlen, umweltfreundlich, keinen Handschlag tun, ergebnislos bleiben, nicht dürfen, den Mund nicht aufmachen, rede keinen Blödsinn, gönnen, halb so schlimm, nicht ganz bei Trost sein, nicht recht bei Trost sein, keine rechte Lust haben, unästhetisch, unformatiert, Nichtraucherin, Nichtraucher  , erst nächste Woche, jdm. nicht das Wasser reichen können, ... habe ich nicht mehr, in Kürze, höchstens, ungeboren, Ungeborenes, etw. versäumen, nichtsdestotrotz, trotzdem, nicht aufhören etw. zu tun, bei etw. durchfallen, ungebeten, kein Auge zu bekommen, es nicht fassen können, einen Rochus auf jdn. haben, jdm. spinnefeind sein, jdn. auf den Tod nicht ausstehen können, jdn. nicht ausstehen können, jdn. nicht riechen können, etw. weglassen, ungebeten, uns, nicht nur, nicht nur, dass ..., ins Wasser fallen, kein Blatt vor den Mund nehmen, reden, wie einem der Schnabel gewachsen ist, nicht auf den Kopf gefallen sein, an Realitätsverlust leiden
nosotros	wir
noticias	Nachrichten, Botschaft, Nachricht, Notiz
novedades	
novela	Novelle, Briefroman, Kriminalroman, Fortsetzungsroman, Roman
noviembre	November  
nuestra	unsere
nuestras	unsere
nuestro	unser
nuestros	unsere
nueva	Neufassung, Neue
nueva york	
nuevamente	erneut, nochmals, von neuem, von Neuem, wieder, neuerdings
nuevas	Neufassung, Neue
nuevo	neu, Neue Weltordnung, Neuer Sol, Neue
nuevos	Neue Weltordnung, Neuer Sol, Neue
numeral	
numerosas	
nunca	nie, niemals
número	algebraische Zahl, Kernladungszahl, Ordnungszahl, Hausnummer, Artikelnummer, Notrufnummer, Einwohnerzahl, Drehzahl, Telefonnummer, ganze Zahl, imaginäre Zahl, irrationale Zahl, Massenzahl, natürliche Zahl, Nummer, Ordinalzahl, Primzahl, rationale Zahl, reelle Zahl, Telefonnummer, transzendente Zahl, Zahl, Anzahl, Ausgabe, Heft
números	algebraische Zahl, Kernladungszahl, Ordnungszahl, Hausnummer, Artikelnummer, Notrufnummer, Einwohnerzahl, Drehzahl, Telefonnummer, ganze Zahl, imaginäre Zahl, irrationale Zahl, Massenzahl, natürliche Zahl, Nummer, Ordinalzahl, Primzahl, rationale Zahl, reelle Zahl, Telefonnummer, transzendente Zahl, Zahl, Anzahl, Ausgabe, Heft
o	entweder ... oder, oder dergleichen, oder ähnlichen, oder aber, entweder, oder, beziehungsweise 
objetivo	objektiv, Weitwinkelobjektiv, Ziel, Zweck
objetivos	Weitwinkelobjektiv, Ziel, Zweck
objeto	Gegenstand, Objekt, unbekanntes Flugobjekt  , Zweck
objetos	Devotionalien, Gegenstand, Objekt, unbekanntes Flugobjekt  , Zweck
obra	Kunstwerk, Buch, Kunstwerk, Theaterstück, Meisterwerk, Musikstück, Werk, Baustelle
obras	Baustelle, Bauarbeiten, Kunstwerk, Buch, Kunstwerk, Theaterstück, Meisterwerk, Musikstück, Werk, Baustelle
obstante	
obtener	etw. erhalten, etw. erlangen, etw. erreichen, etw. erzielen, etw. durch das Spielenlassen von Beziehungen erreichen, etw. bekommen
obtuvo	
ocasiones	
ocho	acht
octubre	Oktober  
ocupacional	
ocurre	
odio	Hass
of	
oferta	Angebot, Stellenangebot, Stellenangebot, Maximalgebot
ofertas	Angebot, Stellenangebot, Stellenangebot, Maximalgebot
oficial	offiziell, Offizierin, Offizier, Geselle
oficiales	
oficina	Büro, Wechselstube, Postamt, Arbeitsamt, Fremdenverkehrsamt, Fremdenverkehrsbüro, Touristeninformation, Geschäftszimmer
oficinas	Büro, Wechselstube, Postamt, Arbeitsamt, Fremdenverkehrsamt, Fremdenverkehrsbüro, Touristeninformation, Geschäftszimmer
ofrece	
ofrecen	
ofrecer	etw. ausschreiben, etw. anbieten, etw. bieten, Hilfe anbieten
oh	
ojalá	hoffentlich
ojo	Auge, Facettenauge, Bullauge, Glasauge, Nadelöhr, Arschloch, Frühlings-Adonisröschen, blaues Auge, Veilchen
ojos	Augen, Glotzaugen, Glotzaugen, Auge, Facettenauge, Bullauge, Glasauge, Nadelöhr, Arschloch, Frühlings-Adonisröschen, blaues Auge, Veilchen
ok	
on	
opciones	
opción	Möglichkeit, Option, Alternative
operaciones	
operación	binäre Verknüpfung, zweistellige Verknüpfung, Eingriff, Operation, einstellige Verknüpfung, monadische Verknüpfung, unäre Verknüpfung, Verknüpfung
operativo	
opiniones	
opinión	Ansicht, Meinung, Standpunkt
oportunidad	Chance, Möglichkeit, Opportunität, Gelegenheit
oportunidades	
orden	Anweisung, Auftrag, Befehl, Haftbefehl, internationaler Haftbefehl, Haftbefehl, Durchsuchungsbefehl, Orden, Tagesordnung, Ordnung, Reihenfolge
organismo	Organismus
organización	Nichtregierungsorganisation  , Organisation
origen	Herkunft, Quelle, Ursprung
original	original, ursprünglich, originell, Original
oro	Gold  , Blattgold
os	entweder ... oder, oder dergleichen, oder ähnlichen, oder aber, beziehungsweise , euch
otra	ein anderes Mal, noch einmal, nochmals, nochmal, ein andermal
otras	ein anderes Mal, noch einmal, nochmals, nochmal, ein andermal
otro	anderer, ein anderer, noch ein
otros	
oye	
oí	
oído	Ohr, Gehör, Mittelohr
oír	hören
p.	
pablo	
pacientes	ambulante Patientin, Patientin, ambulanter Patient, Patient
padre	Pater, Schwiegervater, Alleinerziehender, Vater
padres	Eltern, Pater, Schwiegervater, Alleinerziehender, Vater
pagar	zahlen, jdn./etw. bezahlen, bar bezahlen, mit Bargeld bezahlen, bar bezahlen, mit Bargeld bezahlen, Steuern zahlen, für etw. ein Schweinegeld bezahlen / zahlen, für etw. richtig viel bezahlen
pago	Vorkasse, Bezahlung, Barzahlung, Anzahlung, Zahlung
palabra	Wort für Wort, Schlüsselwort, Fremdwort, Wortungetüm, Vokabel  ], Wort
palabras	Wort für Wort, sehr bewegte Worte, Schlüsselwort, Fremdwort, Wortungetüm, Vokabel  ], Wort
pantalla	Lärmschutzwand, Anzeige, Bildschirm, Radarschirm, Display, Kinoleinwand, Monitor, Flachbildschirm, Touchscreen, Abschirmung
papel	Bibelpapier, Endlosdruckpapier, Endlospapier, Alufolie, Reispapier, Tapete, Packpapier, Zigarettenpapier, Sandpapier, Schleifblatt, Schleifpapier, Schmirgelpapier, Geschenkpapier, Lackmuspapier, Toilettenpapier, Tapete, Papier, Tapete, Hauptrolle, Recyclingpapier, Rolle, Nebenrolle, Funktion
papeles	
papá	Papa
par	gerade, geradzahlig, Beinpaar, Drehmoment, Moment, Paar
para	hierher, zum Schluss, für, für mich, nach, damit, wozu, für dich, für alle, für den Hausgebrauch, um zu
parcial	partiell, teilweise, unausgewogen
parece	angeblich
parecer	wie etw. aussehen, aussehen, den Anschein haben, erscheinen, scheinen, auftauchen, Ansicht, Meinung
pareces	angeblich
parecía	
pareja	Tanzpartnerin, Tanzpartner, Ehe  ohne Trauschein, Paar, Partner
parque	Freizeitpark, Vergnügungspark, Vergnügungspark, Windpark, Stadtpark, Nationalpark, Naturpark, Naturschutzpark, Park, Tiergarten, zoologischer Garten, Laufstall
parte	Anteil, Körperteil, Teil, Partei, Bauteil, Teil, Wetterbericht
partes	Anteil, Körperteil, Teil, Partei, Bauteil, Teil, Wetterbericht
participación	Anteil, Beteiligung, Bürgerbeteiligung, Wahlbeteiligung, Marktanteil, Teilnahme
participantes	Teilnehmerin, Teilnehmer
participar	sich an etw.  beteiligen, zu etw. beisteuern, teilnehmen
particular	besonders, persönlich, Privat-, privat
particulares	
partido	zerbrochen, Freundschaftsspiel, Fußballspiel, Rückspiel, Spiel, Partei
partidos	Freundschaftsspiel, Fußballspiel, Rückspiel, Spiel, Partei
partir	abfahren, abreisen, sich auf den Weg machen Richtung, abfliegen, losgehen, abreisen nach, jdn. zugrunde richten
parís	
pasa	Korinthe, Rosine, Sultanine
pasado	veraltet, überholt, übermorgen, vergangen, vorbei, vorüber, Vergangenheit
pasando	
pasar	jdn. standrechtlich erschießen, etw. reichen, etw. verbringen, sich nicht für jdn./etw. interessieren, auf etw.  verzichten, kein Interesse haben an, eintreten, Staub saugen, staubsaugen, kein Auge zumachen, übernachten, den Urlaub verbringen, passieren, zur Kasse gehen, vorbeikommen, eine Prüfung bestehen, eine Prüfung machen, jdm. einen Auftrag erteilen, sitzen, hereinkommen, hineingehen, übergeben, passen, vergehen, vorbeigehen, vorbeifahren
pase	Kurzpass, Steilpass, Pass, Zuspiel
pasión	Leidenschaft, Passion
paso	nach und nach, Zebrastreifen, Fußgängerüberweg, Durchgang, Grenzübergang, Pass, Schritt, Unterführung, Stufe
pasos	nach und nach, Zebrastreifen, Fußgängerüberweg, Durchgang, Grenzübergang, Pass, Schritt, Unterführung, Stufe
pasto	Gras, Futtermittel, Weide
pasó	
patrimonio	Erbe, Vermögen
paz	Frieden, Friede, Weltfrieden
país	Industrieland, Schwellenland, Entwicklungsland, Exportland, Land, Heimatland, Entwicklungsland, Nachbarland
países	
pedro	
pelo	Kurzhaarschnitt, Kamelhaar, Haar, glattes Haar
película	Liebesfilm, Film, Kinofilm, Stummfilm
películas	Liebesfilm, Film, Kinofilm, Stummfilm
pena	Bedauern, Bestrafung, Todesstrafe, Leid, Strafe
penal	
pensaba	
pensamiento	Gedanke, Acker-Stiefmütterchen
pensando	
pensar	denken, etw. annehmen, etw. meinen, an jdn./etw. denken, in Gedanken woanders sein
pensé	
peor	schlechter, schlimmer
pequeña	Fernsehen, Television  
pequeño	klein, Kleines Nachtpfauenauge
pequeños	Kleines Nachtpfauenauge
per	
perder	jdn./etw. verlieren, bei etw. durchfallen, etw. verpassen, etw. versäumen, jdn./etw. aus den Augen verlieren, den Bus verpassen, in Ohnmacht fallen, Übergewicht bekommen, die Zeit vertrödeln, trödeln, die Fassung verlieren, den Faden verlieren, die Geduld verlieren, aus der Übung kommen, abspecken
perdido	verloren, durcheinander
perdí	
perdón	Entschuldigung, Verzeihung
pereira	
perfecto	perfekt, vollkommen
perfil	unebene Fahrbahn, Profil
periodista	Journalistin, Journalist
periodistas	Journalistin, Journalist
periodo	Beobachtungszeitraum, Halbwertszeit, Periode, Zeitspanne
permanente	ständig, Kaltwelle, Dauerwelle
permiso	Vaterschaftsurlaub, Bewilligung, Landeerlaubnis, Jagdschein, Führerschein, Ausfuhrerlaubnis, Einfuhrerlaubnis, Mutterschaftsurlaub, Fischereischein, Aufenthaltserlaubnis, Aufenthaltsgenehmigung, Drehgenehmigung, Arbeitserlaubnis, Erlaubnis, Genehmigung, Beurlaubung  aufgrund familiärer Angelegenheiten, Beurlaubung  aufgrund persönlicher Angelegenheiten, Beurlaubung  aufgrund eigener Angelegenheiten, Urlaubsschein
permita	
permite	
permiten	
permitir	etw. erlauben, etw. ermöglichen, etw. lassen, etw. dulden
permitirá	
pero	allerdings ..., aber, jedoch, Einwand
perro	Jagdhund, Kampfhund, Schoßhündchen, Wachhund, Blindenhund, Hund, Blindenhund
persona	Allergiker, Person  europäischer Herkunft, Bezugsperson, berühmte Person, natürliche Person, juristische Person, juristische Person, Person, Obdachloser, Obdachloser, mutige Person, tapfere Person
personaje	Figur, Person, Charakter
personajes	Figur, Person, Charakter
personal	persönlich, Personal, Belegschaft
personales	
personas	Allergiker, Person  europäischer Herkunft, Bezugsperson, berühmte Person, natürliche Person, juristische Person, juristische Person, Person, Obdachloser, Obdachloser, mutige Person, tapfere Person
período	Inkubationszeit, Zwischeneiszeit
perú	
pesar	wiegen, übergewichtig sein, Kummer
peso	Geburtsgewicht, Körpergewicht, Abtropfgewicht, Gewicht  , Untergewicht, Schwergewicht, Peso, Waage
pesos	Geburtsgewicht, Körpergewicht, Abtropfgewicht, Gewicht  , Untergewicht, Schwergewicht, Peso, Waage
petro	
petróleo	Erdöl
pide	
pidió	
pido	
pie	Spreizfuß, Messschieber, Fuß, Plattfuß, Stiel
piedra	Sandstein, Kalkstein, Schleifstein, Wetzstein, Schleifstein, Wetzstein, Edelstein, Bimsstein, Halbedelstein, Stein
piel	Kalbsleder, Apfelschale, Orangenschale, Orangenhaut, Haut, Pelz, Leder
piensa	
piensas	
pienso	Futtermittel
pies	Füße, Spreizfuß, Messschieber, Fuß, Plattfuß, Stiel
piscina	Hallenbad, Kühlbecken, Schwimmbad, Schwimmbecken
piso	Erdgeschoss, Wohngemeinschaft  , Eigentumswohnung, Eigentumswohnung, Etage, Stockwerk, Fußboden, Wohnung
pisos	Erdgeschoss, Wohngemeinschaft  , Eigentumswohnung, Eigentumswohnung, Etage, Stockwerk, Fußboden, Wohnung
placer	Freude, Genuss, Vergnügen, Vergnügung
plan	Studienplan, Lehrplan, Plan
planeación	
planes	
planta	Wasserpflanze, Erdgeschoss, Parterre, fleischfressende Pflanze, Karnivore, Fußsohle, Meerwasserentsalzungsanlage, Kläranlage, Etage, Grundriss, Atomkraftwerk, Zierpflanze, Pflanze, Pilotanlage, Trinkwasseraufbereitungsanlage, Station, Stockwerk, Kletterpflanze
plantas	Wasserpflanze, Erdgeschoss, Parterre, fleischfressende Pflanze, Karnivore, Fußsohle, Meerwasserentsalzungsanlage, Kläranlage, Etage, Grundriss, Atomkraftwerk, Zierpflanze, Pflanze, Pilotanlage, Trinkwasseraufbereitungsanlage, Station, Stockwerk, Kletterpflanze
plataforma	Kontinentalplatte, Ölplattform
playa	Strand
plaza	Stierkampfarena, Hauptplatz, Platz
plazo	Lieferfrist, Lieferzeit, Anmeldefrist, Frist, Rate, Termin
pm	
población	Bevölkerungszahl, Bevölkerung, Weltbevölkerung, Ortschaft, Ort, Population, Landbevölkerung, Stadtbevölkerung, Volk
pobre	arm
poco	allmählich, nach und nach, unklar, schadstoffarm, kurz darauf, gering, schwach gebraten, unorthodox, unähnlich, wenig
pocos	allmählich, nach und nach, unklar, schadstoffarm, kurz darauf, schwach gebraten, unorthodox, unähnlich
podemos	
poder	mit jdm. fertig werden, können, dürfen, Kaufkraft, Heilkraft, Macht, Zauberkraft, höchste Macht, Vollmacht
podrá	
podrán	
podrás	
podría	
podríamos	
podrían	
podrías	
podía	
policía	Militärpolizei  , Polizistin, Polizei, Polizist
política	Agrarpolitik, Sparpolitik, Umweltpolitik, Innenpolitik, Migrationspolitik, Geldpolitik, Währungspolitik, Politikerin, Politik
políticas	Agrarpolitik, Sparpolitik, Umweltpolitik, Innenpolitik, Migrationspolitik, Geldpolitik, Währungspolitik, Politikerin, Politik
político	politisch, Politiker
políticos	Politiker
pon	
pone	
poner	jdn./etw. in Sicherheit bringen, jdn. mit jdm. verbinden, jdn. nerven, jdn. in etw. einweihen, jdn. entlassen, jdm. etw. zur Verfügung stellen, etw. einweichen, etw. hervorheben, hervorheben, etw. in Frage stellen, etw. in Zweifel ziehen, etw. freigeben, etw. ankurbeln, etw. in Gang setzen, etw. organisieren, etw. aufräumen, etw. anlegen, etw. legen, etw. setzen, etw. stellen, etw. auf den Kopf stellen, den Finger in die Wunde legen, etw.  ein Ende setzen, hintun, die Wäsche machen, den Tisch decken, das Radio lauter stellen, fremdgehen, jdn. nervös machen, jdm. Worte in den Mund legen, sich aus dem Staub machen, annehmen, dass ..., Marktregulierung, ein zusätzliches Bett hineinstellen, jdn. mit einer Geldstrafe belegen, jdm./etw. einen Namen geben, die Betonung auf etw. legen, etw. betonen
popular	populär, Volks-, volkstümlich
por	dadurch, dadurch, damals, hier in der Nähe, hier in der Gegend, mit dem Flugzeug, per Luftpost, zufällig, apropos, fürwahr, übrigens, absolut, infolgedessen, somit, mit der Post, auf eigene Faust, wegen, aus Neugier, aus Neugierde, unterhalb, sozusagen, im Inneren, selbstverständlich, bedauerlicherweise, leider, unglücklicherweise, durch den, überall, doppelt, durch, infolge, zum Beispiel , aus Angst vor, kraft Gesetzes, von mir aus, geschweige denn ..., von Berufs wegen, im Auftrag von, andererseits, darüber hinaus, andererseits, beinahe, erstmals, aus einer puren Laune heraus, warum, was, weshalb, wieso, infolge, getrennt, vorsichtshalber, falls, für alle Fälle, auf ewig, für immer, im Falle, sicher ist sicher, selbstständig, selbständig, natürlich, selbstverständlich, von allein, daher, darum, telefonisch, überall, in großem Stil, mit dem Zug, mit der Bahn, um ... zu, einerseits, für ein Jahr, für einen kleinen Augenblick, für einen kleinen Moment, für einen kurzen Augenblick, für einen kurzen Moment, für einen Apfel und ein Ei, beinahe, um ein Haar, um Haaresbreite, dahingestellt, von, wegen, pro, endlich, schließlich, zu guter Letzt, zuletzt
porcentaje	Blutalkoholkonzentration  , Gehalt, Prozentsatz
porque	damit, da, weil
porqué	
posee	
posibilidad	Aussicht, Möglichkeit
posibilidades	
posible	möglich
posición	Arbeitsstellung, stabile Seitenlage, Arbeitsstellung, Marktanteil, Endlage, Grundstellung, stabile Seitenlage, Position, Stellung, Haltung, Lage
posteriormente	nachher, nachträglich, später
precio	mittlere Preisklasse, Kaufpreis, Ladenpreis, Verkaufspreis, Preis, Wert
precios	mittlere Preisklasse, Kaufpreis, Ladenpreis, Verkaufspreis, Preis, Wert
preferiblemente	
pregunta	Abfrage, Leitfrage, Schlüsselfrage, Frage
preguntas	Abfrage, Leitfrage, Schlüsselfrage, Frage
pregunto	
premio	Sachprämie, Geldprämie, Hauptgewinn, Nobelpreisträger, Preis, Prämie
prensa	Lokalpresse, Presse, Pressewesen, Zeitungswesen, Presse
preocupes	
preparación	Vorbereitung
presencia	Militärpräsenz, Gegenwart, Erscheinung, Anwesenheit
presenta	
presentación	Darbietung, Darstellung, Gestaltung, Präsentation, Vorführung, Vorstellung
presentado	gesponsert
presentan	
presentar	jdn./etw. vorstellen, etw. zeigen, jdm. ein Vergehen anlasten, den Rücktritt erklären, seinen Rücktritt einreichen, eine Bittschrift vorlegen
presentaron	
presente	anwesend, gegenwärtig, Präsens, Gegenwart, Geschenk
presentes	gegenwärtig, Präsens, Gegenwart, Geschenk
presentó	
presidencial	Präsidentschafts-
presidente	Präsidentin, Zunftmeister, Präsident, Vorsitzender
presión	atmosphärischer Druck, Luftdruck, Druck, hydrostatischer Druck, Blutdruck, Selektionsdruck
presupuesto	Budget, Kostenvoranschlag, Investitionsbudget, Marketingbudget, Werbebudget, Sonderbudget, Etat, Haushaltskasse, Finanzplanung, Gelder, Haushalt, Kostenvoranschlag, Staatsbudget
previo	vorhergehend
primer	erster Kontakt, Vordergrund, Vorspeise, erste Halbzeit
primera	beste Qualität, Ministerpräsidentin, Premierministerin, erster Gang
primeras	beste Qualität, Ministerpräsidentin, Premierministerin, erster Gang
primero	erste, zuerst
primeros	Erste Hilfe, erste Hilfe
principal	Haupt-, hauptsächlich, wesentlich
principales	
principalmente	hauptsächlich, überwiegend
principio	Generationenprinzip, Großvater-Vater-Sohn-Prinzip, Anfang, Grundsatz
principios	Generationenprinzip, Großvater-Vater-Sohn-Prinzip, Anfang, Grundsatz
privada	
privado	privat
probablemente	sicherlich, vermutlich , wahrscheinlich, wohl
problema	Umweltproblem, Aufgabe, Hauptproblem, Problem
problemas	Umweltproblem, Aufgabe, Hauptproblem, Problem
procedimiento	Ladevorgang, Insolvenzverfahren, Strafverfahren, Verfahren, Vorgehensweise
procedimientos	Ladevorgang, Insolvenzverfahren, Strafverfahren, Verfahren, Vorgehensweise
proceso	Zivilprozess, Zivilverfahren, Strafverfahren, Chargenprozess, Prozess, Redoxverfahren, Verfahren, Vorgang
procesos	Zivilprozess, Zivilverfahren, Strafverfahren, Chargenprozess, Prozess, Redoxverfahren, Verfahren, Vorgang
procuraduría	
producción	Milcherzeugung, Fließbandfertigung, Erzeugung, Fabrikation, Herstellung, Produktion
produce	
producto	Fleischerzeugnis, Abfallprodukt, Abbauprodukt, Putzmittel, Erzeugnis, Pflanzenschutzmittel, Bruttoinlandsprodukt  , Produkt, Ware
productos	Arzneimittel, Fleischerzeugnis, Abfallprodukt, Abbauprodukt, Putzmittel, Erzeugnis, Pflanzenschutzmittel, Bruttoinlandsprodukt  , Produkt, Ware
produjo	
profesional	beruflich, Berufs-, berufsmäßig, professionell
profesionales	
profesor	Deutschlehrer, Biolehrer, Biologielehrer, Sportlehrer, Spanischlehrer, Französischlehrer, Physiklehrer, Erdkundelehrer, Geografielehrer, Geographielehrer, Geschichtslehrer, Englischlehrer, Mathelehrer, Mathematiklehrer, Chemielehrer, Religionslehrer, ordentlicher Professor, Lehrer, Dozent, Professor
profesores	
programa	Software, Antivirusprogramm, Hilfsprogramm, Realityshow, Fernsehprogramm, Programm, Spielplan
programación	lineare Programmierung, Programmierung
programas	Software, Antivirusprogramm, Hilfsprogramm, Realityshow, Fernsehprogramm, Programm, Spielplan
promedio	Durchschnitt
promoción	Verkaufsaktion, Beförderung, Förderung
pronto	bald, in Kürze, schnell
propia	
propiedad	Besitz, Eigentum, Privatbesitz, Eigenschaft
propiedades	
propio	persönlich, eigen, selbst
propios	eigen, selbst
propuesta	absurder Vorschlag, ungewohnter Vorschlag, Vorschlag, Antrag
propuestas	absurder Vorschlag, ungewohnter Vorschlag, Vorschlag, Antrag
propósito	Absicht, Vorsatz, Zweck
protección	Datenschutz, Artenschutz, Bodenschutz, Strahlenschutz, Schutz, Sonnenschutz
proteger	jdn./etw. beschützen, jdn./etw. schützen
protegida	
provincia	Provinz
proyecto	Bauprojekt, Projekt
proyectos	Bauprojekt, Projekt
prueba	Beweis, Alkoholblutprobe, Alkoholprobe, Alkoholtest, Blutalkoholtest, Eignungstest, Kostprobe, Nachweis  der Staatsangehörigkeit, Schwangerschaftstest, Feuerprobe, Nachweis, Test, Prüfung, Wettkampf, Erprobung, Versuch
pruebas	Beweis, Alkoholblutprobe, Alkoholprobe, Alkoholtest, Blutalkoholtest, Eignungstest, Kostprobe, Nachweis  der Staatsangehörigkeit, Schwangerschaftstest, Feuerprobe, Nachweis, Test, Prüfung, Wettkampf, Erprobung, Versuch
práctica	Praxis, Übung
prácticas	Praktikum, Praxis, Übung
próxima	
próximo	nächster, kommend
próximos	kommend
psicología	Psychologie
publicación	Publikation, Veröffentlichung
publicada	
publicado	veröffentlicht
publicados	
publicidad	Reklame, Werbespot, Werbung
pude	
pudiera	
pudo	
pueblo	Fischerdorf, Fischerdorf, Dorf, Volk
pueda	
puedan	
puedas	
puede	möglicherweise
pueden	
puedes	möglicherweise
puedo	
puente	Luftbrücke, Brücke, Hängebrücke, Nasensattel, Zugbrücke
puerta	Schiebetür, Flügeltür, Haustür, Drehtür, Seitentür, Haupttor, Haupttür, Hintertür, Tür
puertas	Schiebetür, Flügeltür, Haustür, Drehtür, Seitentür, Haupttor, Haupttür, Hintertür, Tür
puerto	Hafen, Alpenpass, Anschluss, Tiefwasserhafen, Umladehafen, Umschlaghafen, Binnenhafen, Fischereihafen, Fischerhafen, Port, Schnittstelle, Pass
pues	also, dann, denn, doch, nun, so
puesto	da, weil, Arbeitsplatz, Platz, Stelle, Marktstand
puestos	da, weil, Arbeitsplatz, Platz, Stelle, Marktstand
punto	G-Punkt, Grüner Punkt, Semikolon, Strichpunkt, Himmelsrichtung, Nullpunkt, Höhepunkt, Kettenstich, Gefrierpunkt, Kreuzstich, Siedepunkt, Dreiländereck, Treffpunkt, Schmelzpunkt, Gräfenberg-Zone, Sehenswürdigkeit, Ausgangspunkt, Kettmasche  , Gesichtspunkt, Standpunkt, Schwachpunkt, Masche, Prozentpunkt, Punkt, chirurgische Naht, Dreiländereck
puntos	G-Punkt, Punkte je Zoll  , Gesichtspunkt, Standpunkt, Schwachpunkt, Masche, Prozentpunkt, Punkt, chirurgische Naht, Dreiländereck
puso	
puta	Dirne, Flittchen, Hure, Nutte, Schlampe, Strichmädchen
página	Blatt, Frontpage, Hauptseite, Homepage, Startseite, Internetseite, Webseite, Seite, Webseite, Website
páginas	Blatt, Frontpage, Hauptseite, Homepage, Startseite, Internetseite, Webseite, Seite, Webseite, Website
pérdida	Verlust
pérez	
pública	
públicas	
público	Publikum, öffentlich
públicos	Publikum
q	
que	mehrdeutig, als, berufsqualifizierend, dass, der, wochenlang, nachfolgend, lohnend, nachfolgend, weil, wo
queda	
quedan	
quedó	
queremos	
querida	
querido	lieb
quería	
querías	
quien	welcher
quienes	
quiera	
quieras	
quiere	
quieren	
quieres	du willst
quiero	will
quise	
quisiera	ich / er / sie / es hätte gerne
quizá	vielleicht
quizás	vielleicht
quién	wer
qué	was
quédate	
radio	Taschenradio, Radio, Radiogerät, Radium  , Radius, Speiche, Radio
rafael	
ramírez	
raro	selten, seltsam, merkwürdig, rar, absonderlich
razones	
razón	Hauptgrund, Verstand, Beweggrund, Grund, Räson, Vernunft
real	reell, tatsächlich, königlich
reales	
realidad	Realität, Wirklichkeit
realiza	
realización	Verwirklichung
realizadas	
realizado	
realizan	
realizar	etw. absolvieren, etw. durchführen, etw. machen, etw. tun, etw. verwirklichen, etw. ausführen
realizará	
realizó	
realmente	eigentlich, wirklich
recibe	
recibir	jdn. empfangen, etw. bekommen, etw. erhalten
recibió	
recibo	Empfangsschein, Quittung, Empfang
reciente	neu, neuartig, vor kurzem geschehen
recién	Neugeborenes, frisch gestrichen, soeben
reconocimiento	Anerkennung, Aufklärung, ärztliche Untersuchung
recuerda	
recuerdas	
recuerdo	Kindheitserinnerung, Andenken, Souvenir
recurso	Notbehelf, Staatsmittel, Rohstoff, Ressource, Hilfsmittel, Mittel
recursos	Staatsressourcen, Personalwesen, Bodenschätze, öffentliche Mittel, Notbehelf, Staatsmittel, Rohstoff, Ressource, Hilfsmittel, Mittel
red	Schleppnetz, Rechnernetz, Local Area Network  
redes	
referencia	Aktenzeichen, Anspielung, Berufung, Bezugnahme, Arbeitszeugnis, Empfehlungen, Führungsgröße, Hinweis, Merkzeichen, Referenzen, Referenzierung, Referenz, Verweisung, Verweis, Zeichen, Bericht, Erzählung, Bezug
reforma	Agrarreform, Steuerreform, Reform, Gesundheitsreform
regalo	Geburtstagsgeschenk, Geschenk
regional	regional
regiones	
registro	Handelsregister, Register, Verzeichnis
región	Sonderverwaltungsregion, Bereich, Spann, Region
reglas	Finanzmarktregeln, Regeln, Simpsonregel, simpsonsche Regel, Maßstab, Eselsbrücke, Regel, Lineal
regresar	aus etw.  zurückkehren, von etw.  zurückkehren, zurückkommen, zurückkehren
regreso	Rückfahrt, Rückkehr
reino	Königreich, Pflanzenreich
relacionada	
relacionadas	
relacionados	
relaciones	Beziehungen, Geschäftsbeziehungen
relación	Fernbeziehung, Beziehung, Handelsbeziehung, feste Beziehung, Hinsicht, Arbeitsverhältnis, Preis-Leistungs-Verhältnis, berufliche Beziehung, Geschlechtsverkehr, Verhältnis
renault	
rendimiento	Gewährleistung, Ertrag, Wirkungsgrad, Leistung
representa	
representación	Aufführung, Vertretung
representante	Vertreterin, Anklagevertreter, Repräsentant, Vertreter
representantes	Vertreterin, Anklagevertreter, Repräsentant, Vertreter
república	Bananenrepublik, Republik
requiere	
requisitos	Anforderung
reserva	Auswechselspielerin, Eigentumsvorbehalt, Reservierung, Vorbehalt, Zurückhaltung, Platzreservierung, Auswechselspieler
reservar	etw. buchen, etw. reservieren, etw. vorbestellen
residencial	Wohn-
resolución	Bescheid, Bildauflösung, Bildschirmauflösung, Bildauflösung, Resolution, Beschluss, Entschluss, Lösung, Entschlossenheit, Tatkraft
resolver	etw. lösen, eine Gleichung lösen, eine Aufgabe lösen
respectivo	jeweilig
respecto	
respeto	Achtung, Respekt
responder	jdm. antworten, auf etw. antworten, entgegnen
responsabilidad	Haftpflicht, Haftung, Verantwortung
responsable	verantwortlich, Verantwortliche, Verantwortlicher
responsables	Verantwortliche, Verantwortlicher
respuesta	Antwort, Erwiderung
restaurante	Raststätte, Restaurant
restaurantes	Raststätte, Restaurant
resto	Rest
restos	Rest
resulta	
resultado	Ergebnis, Endergebnis, Folge, resultat, Wirkung
resultados	Ergebnisse, Ergebnis, Endergebnis, Folge, resultat, Wirkung
reuniones	
reunión	Besprechung, Gipfeltreffen, Sitzung, Treffen, Versammlung
revisión	Check-up
revista	Illustrierte, Zeitschrift
rey	Wachtelkönig, Wiesenralle, König
rico	artenreich, reich, lecker, reizend, prächtig, Schatz
riesgo	Ansteckungsrisiko, Kreditrisiko, Invalidisierungsrisiko, Brandgefahr, Gefahr, Risiko
risaralda	
rodríguez	
ropa	Herrenbekleidung, Bettbezug, Buntwäsche, Sportkleidung, Markenkleidung, Sportkleidung, Damenoberbekleidung, Freizeitkleidung, Dessous, Reizwäsche, Unterwäsche, Kleidung, Nachtwäsche, Wäsche, Wäsche, Wäsche
rural	Land-, ländlich
rápido	schnell, kurz, rasch, Stromschnelle
régimen	Diät, Strafvollzug, Regime
río	flussabwärts, flussaufwärts, Fluss, Pasig, Tessin
sabe	
sabemos	
saben	
saber	wissen, etw. auswendig können, etw. aus zuverlässiger Quelle wissen, etw. beherrschen, etw. erfahren, etw. können, etw. kennen, schmecken nach, Wissen
sabes	
sabía	
sacar	jdn./etw. herausziehen, jdn./etw. erwähnen, etw. nach vorn bringen, etw. öffentlich versteigern, etw. aus etw. holen, etw. entnehmen, etw. herausnehmen, den Hund spazieren führen, aufschlagen, aus etw. Nutzen ziehen, jdn. aus der Fassung bringen, Geld abheben, den Führerschein machen, sich den Bauch vollschlagen, den Abfall hinausbringen, jdm. die Zunge herausstrecken, aus etw. Nutzen ziehen, ein Boot an Land ziehen, einen Rückschluss aus etw. ziehen, ein Bild machen, ein Foto machen, knipsen
sal	Hirschhornsalz, Meersalz, Mineralsalz, Salz
sala	Gerichtssaal, Tagungsraum, Kongresssaal, Warteraum, Wartezimmer, Wohnzimmer, Entbindungsstation, Kinderstation, Versammlungsraum, Notaufnahme, Säulensaal, Saal
salario	Managergehalt, Einkommen, Gehalt, Lohn, Mindestgehalt
sale	
salga	
salida	Ausgang, Notausgang, Sonnenaufgang, Ausfahrt, Abreise
salir	etw. kosten, abreisen, segeln gehen, ausgehen, gelingen, sich auf die Suche nach jdm./etw. machen, bei etw. durchfallen, gewinnen, hinausgehen, herausfahren
salió	
salud	Gesundheit
salvar	jdn./etw. retten
salón	Unterrichtsraum, Spielhalle, Salon, Wohnzimmer
samsung	
san	
sangre	Blut
santa	Heilige
santander	
santiago	
santo	heilig, Heiliger, Namenstag
santos	Heiliger, Namenstag
sat	
se	man sagt ..., man kann, sich, sich selbst, man
sea	
sean	
seas	
sección	Abteilung, Rechtsabteilung, Sektion
secretaria	Sekretärin
secretario	Protokollführer, Generalsekretär, Sekretär
secretaría	Geschäftsstelle, Sekretariat
secreto	geheim, Bankgeheimnis, Fernmeldegeheimnis, Betriebsgeheimnis, Geheimnis, Briefgeheimnis, Berufsgeheimnis
sector	Bereich, Branche, Dienstleistungssektor, Informatiksektor, Sektor, Dienstleistungssektor, Textilgewerbe
sectores	
sede	Hauptuni, Universitätshauptgebäude, Hauptsitz
seguimiento	
seguir	jdm./etw. folgen, jdm./etw. nachgehen, geradeaus fahren, fortsetzen, etw. weiter tun, gleich bleiben, geradeaus fahren, etw. weiterhin nicht tun, geradeaus gehen, geradeaus weitergehen, geradeaus weiterfahren, weitermachen
segunda	zweiter Gang
segundo	zweite, Sekunde
segura	
seguridad	Luftsicherheit, Sicherheit, Sicherung, Verkehrssicherheit
seguro	selbstbewusst, selbstsicher, gewiss, sicher, zuverlässig, sicher, Arbeitslosenversicherung, Krankenversicherung, Hausratsversicherung, Hausratsversicherung, Arbeitslosenversicherung, Reiserücktrittsversicherung, Haftpflichtversicherung, Reiseversicherung, Lebensversicherung, Sozialversicherung, Versicherung
según	angeblich, gemäß , nach, angeblich
seis	sechs
selección	Nationalmannschaft, Auswahl, Selektion
semana	31. Schwangerschaftswoche  , Woche
semanas	31. Schwangerschaftswoche  , Woche
semestre	Wintersemester, Sommersemester, Semester, Halbjahr
sena	
senado	Senat
sencillo	einfach, schlicht, Kleingeld
sentencia	Schiedsurteil, Strafurteil, Revisionsurteil, Scheidungsurteil, rechtskräftiges Urteil, rechtskräftiges Urteil, Gerichtsurteil, Urteil, Sentenz, Sinnspruch
sentido	gesunder Menschenverstand, Sinn
sentimientos	Gefühl, Bedauern
sentir	etw. empfinden, etw. fühlen, etw. bedauern, tief bewegt sein, tief gerührt sein, Meinung, Laune
septiembre	September  
ser	nach etw. süchtig sein, Dreh- und Angelpunkt sein, jdm. gehören, kommen aus, sehr alt sein, köstlich schmecken, aus Madrid kommen, aufgeweckt sein, ein guter Mensch sein, einsame Spitze sein, jdm. nachstehen, fremdgehen, trödeln, nötig sein, Muskeln haben, muskulös sein, sehr gerissen sein, stammen aus, schüchtern sein, für etw. anfällig sein, zu etw. neigen, anfällig sein für, pünktlich sein, bei etw. durchfallen, sicher sein, sein, wohl noch in der Steinzeit leben, eine schrullige Hausfrau sein, ein findiger Kopf sein, sehr schlecht sein, schweigen wie ein Grab, eine Katastrophe sein, chaotisch sein, unordentlich sein, ein Nervenbündel sein, über fünf Ecken verwandt sein, ein alter Hase sein, lästig sein, unangenehm sein, ein Herz und eine Seele sein, rechtsgültig sein, rechtskräftig sein, in Kraft getreten sein, schlau sein, Fabelwesen, Mensch, Lebewesen, Lebewesen, Geschöpf, Wesen
seres	
serie	Handlungsabfolge, Fernsehserie, Reihe, Serie
serio	ernst, ernsthaft, gesetzt, vertrauenswürdig
server	
servicio	Bedienung inbegriffen, Lieferung  frei Haus, Pannendienst, Pannendienst, Kinderbetreuung, Short Message Service, Rettungsdienst, Dienstleistung, Dienst, Kriegsdienst, Militärdienst, Wehrdienst, Rettungsdienst, Damentoilette, Geheimdienst, Service, Toilette, Bedienung
servicios	Bedienung inbegriffen, Lieferung  frei Haus, Pannendienst, Pannendienst, Kinderbetreuung, Short Message Service, Rettungsdienst, Dienstleistung, Dienst, Kriegsdienst, Militärdienst, Wehrdienst, Rettungsdienst, Damentoilette, Geheimdienst, Service, Toilette, Bedienung
será	
serán	
serás	
seré	
sería	
sesión	Vorstellung
sexo	Geschlecht, Geschlechtsverkehr, Sex
sexual	geschlechtlich, Sexual-, sexuell
señal	Alarmsignal, Rauchsignal, Lesezeichen, Verkehrsschild, Verkehrszeichen, Verkehrsschild, Zeichen
señala	
señaló	
señor	Herr
señora	Frau
señorita	Fräulein
si	falls, anderenfalls, andernfalls, sonst, ob, wenn, H
sido	
siempre	immer, vorausgesetzt, dass ...
siendo	
siente	
sientes	
siento	
siete	sieben
siglo	20. Jahrhundert, Jahrhundert  , Zeitalter
significa	
significado	Bedeutung
sigue	
siguen	
sigues	
siguiente	anschließend, folgend, nachfolgend, Nächste, Nächster
siguientes	Nächste, Nächster
siguió	
similar	ähnlich
similares	
simplemente	bloß, einfach
sin	alkoholfrei, rechtsunfähig, stetig, freibleibend, spurlos, obdachlos, zweifellos, herrenlos, allerdings, dennoch, indes, jedoch, nichtsdestotrotz, trotzdem, emotionslos, ohne Schuppen, mühelos, hoffnungslos, entgrätet, undatiert, endlos, ohne Kohlensäure, fettfrei, ohne etwas erreicht zu haben, unverrichteter Dinge, lautlos, obdachlos, entbeint, beispiellos, immerzu, mondlos, ohne größere Umschweife, ohne, widerstandslos, stetig, unaufhörlich, einzigartig, ohne mit der Wimper zu zucken, unpasteurisiert, enthäutet, aussichtslos, beispiellos, nie da gewesen, ohne Probleme, problemlos, stumpf, ohne dass, ohne Zuhilfenahme von, hoffnungslos, ergebnislos, ohne festes Ziel, ziellos, ungesalzen, nahtlos, obdachlos, wertlos
sino	sondern
siquiera	wenigstens
sirve	
sistema	Energiespeichersystem, Bankensystem, Gefäßsystem, kardiovaskuläres System, Blutbahn, Blutkreislauf, Energieversorgungsanlage, Backenschnellwechselsystem, Schnellwechselsystem, Koordinatensystem, Zielsystem, Qualitätsmanagementsystem  , Navigationssystem, Kühlsystem, Nullpunktspannsystem, Spannsystem, Verdauungssystem, Ökosystem, Wirtschaftssystem, endokrines System, Sternsystem, Immunsystem, Immunsystem, lymphatisches System, Lymphsystem, Schmiersystem, metrisches Maßsystem, Nervensystem, Betriebssystem, Periodensystem, Planetensystem, Fortpflanzungssystem, Atmungssystem, Sonnensystem, System, Harnsystem
sistemas	Energiespeichersystem, Bankensystem, Gefäßsystem, kardiovaskuläres System, Blutbahn, Blutkreislauf, Energieversorgungsanlage, Backenschnellwechselsystem, Schnellwechselsystem, Koordinatensystem, Zielsystem, Qualitätsmanagementsystem  , Navigationssystem, Kühlsystem, Nullpunktspannsystem, Spannsystem, Verdauungssystem, Ökosystem, Wirtschaftssystem, endokrines System, Sternsystem, Immunsystem, Immunsystem, lymphatisches System, Lymphsystem, Schmiersystem, metrisches Maßsystem, Nervensystem, Betriebssystem, Periodensystem, Planetensystem, Fortpflanzungssystem, Atmungssystem, Sonnensystem, System, Harnsystem
sitio	Ort, Platz, Belagerung, Kessel
sitios	Ort, Platz, Belagerung, Kessel
situaciones	
situación	Ausgangslage, Finanzlage, Lage, Notlage, Situation
situado	vorgelagert, gelegen
sobre	auf, etwa, oberhalb, besonders, hauptsächlich, in erster Linie, vor allem, Fensterbriefumschlag, Briefumschlag, über
social	gesellschaftlich, sozial
sociales	
sociedad	Gesellschaft  mit beschränkter Haftung , Zivilgesellschaft, Tochtergesellschaft, Gesellschaft, Handelsgesellschaft
software	Software
sola	
solamente	bloß, lediglich, nur, wenigstens
soldados	Soldatin, Bleisoldat, Zinnsoldat, Grenzsoldat, Soldat
solicita	
solicitud	Asylantrag, Gesuch, Bewerbung
solicitó	
solo	allein, alleine, bloß, einsam, einzeln, lediglich, alleinig, einzig
soluciones	
solución	Salmiakgeist, Lösung
solía	
somos	
son	Laut, Ton
sonido	Klang
soporte	Tonträger, Gestell, Software, Stütze, Unterstützung, Träger
soy	ich bin für die Rechnungen verantwortlich
sr	
sra	
srta	
su	ihr, sein, Ihr
subjetiva	
sucede	
suele	
suelo	Boden, Fußboden
suena	
suerte	Glück, Schicksal
sueño	Schlaf, Traum, Wunschtraum
suficiente	ausreichend, genügend
suficientes	
sujeto	
suma	Addition, Summe
sun	
superar	jdn./etw. übertreffen, etw. überwinden, etw. überschreiten
superficie	Fläche, Oberfläche, Erdoberfläche
superior	modern, obere, Vorgesetzter
supone	
supongo	
supuesto	mutmaßlich, vermeintlich, vermutlich, Annahme
sur	Süden  
sus	Ihre, ihre, seine, Ihr
sábado	Samstag  
sé	
sí	ja, sich selber, sich selbst
sólo	lediglich, nur
tabla	Schi, Ski, Invaliditätstafel, Sterbetafel, Einmaleins, Bügelbrett, Käseaufschnitt, Käseplatte, Snowboard, Surfbrett, Sterbetafel, Periodensystem  der Elemente, Brett, Tabelle
tal	solch ], möglicherweise, vielleicht
tales	
tamaño	Losgröße, Größe
también	auch, außerdem, ebenfalls, ebenso, gleichwohl
tampoco	auch nicht, ebensowenig
tan	ebenso ... wie, so ... wie, sobald, bloß, so spät, so
tanta	
tanto	sowohl ... als auch ..., so viel wie, so viel, Prozent
tarde	früher oder später, spät, Abend, Nachmittag
tarea	Verwaltungsaufgabe, Aufgabe, Auftrag, Haushaltsarbeit, unerledigte Aufgabe, Hauptaufgabe
tarjeta	gelbe Karte, Chipkarte, Waffenbesitzkarte, Kreditkarte, Debitkarte, Bordkarte, Glückwunschkarte, Speicherkarte, Soundkarte, Telefonkarte, Visitenkarte, Graphikkarte, Karte, Postkarte, Prepaidkarte, rote Karte, Telefonkarte
tasa	Trefferquote, Wechselgebühr, kumulierte jährliche Wachstumsrate, Arbeitslosenquote, Verdunstungsrate, Steuersatz, Inflationsrate, Investitionsquote, Steuersatz, Sterblichkeitsrate, Gebühr, Rate
tasas	Trefferquote, Wechselgebühr, kumulierte jährliche Wachstumsrate, Arbeitslosenquote, Verdunstungsrate, Steuersatz, Inflationsrate, Investitionsquote, Steuersatz, Sterblichkeitsrate, Gebühr, Rate
te	dich, dir
teatro	Kasperletheater, Puppentheater, Theater, Zirkus, Schauspielhaus, Schauplatz
tecnología	Vakuumspanntechnik, Spanntechnik, Bäckereitechnologie, Spanntechnik, Technologie
tecnologías	Vakuumspanntechnik, Spanntechnik, Bäckereitechnologie, Spanntechnik, Technologie
telecomunicaciones	Telekommunikation
televisión	Television  , Fernsehen, Kabelfernsehen, Satellitenfernsehen, Satellitenfernsehen, TV, Satellitenfernsehen, Fernsehapparat, Fernseher, Fernsehgerät, Flimmerkiste
teléfono	Mobiltelefon, Handy, Smartphone, Mobiltelefon, Handy, Telefon
tema	Gesprächsthema, Thema
temas	Gesprächsthema, Thema
temo	
templo	Tempel
temporada	Hauptsaison, Hochsaison, Nachsaison, Nebensaison, Prüfungszeit, Saison, Staffel
temporadas	Hauptsaison, Hochsaison, Nachsaison, Nebensaison, Prüfungszeit, Saison, Staffel
ten	
tendremos	
tendrá	
tendrán	
tendrás	
tendré	
tendría	
tenemos	
tener	haben
tenga	
tengan	
tengas	
tengo	
tenia	Bandwurm
tenido	
teniendo	
teniente	Leutnant
tenía	
tenían	
tenías	
teoría	Galoistheorie, Gruppentheorie, Evolutionstheorie, Informationstheorie, Relativitätstheorie, Chaostheorie, Zahlentheorie, Theorie
tercer	
tercera	dritter Gang
terminar	etw. beenden, etw. absolvieren, enden, zu Ende gehen
terminó	
terreno	irdisch, Mull, Grundstück, Industriegelände, Bereich
territoriales	
territorio	Gebiet, Territorium
texto	Text
the	
thu	
ti	
tiempo	Umrüstzeit, Wartezeit, Rüstzeit, Umrüstzeit, herrliches Wetter, Freizeit, Wetter, Witterung, Zeit
tiempos	Umrüstzeit, Wartezeit, Rüstzeit, Umrüstzeit, herrliches Wetter, Freizeit, Wetter, Witterung, Zeit
tiendas	Lebensmittelladen, Lebensmittelgeschäft, Zelt, Lebensmittelladen, Musikladen, Reformhaus, Souvenirladen, Kleidergeschäft, Bioladen, Ökoladen, Geschäft, Laden, Internetladen, Zelt
tiene	
tienen	
tienes	
tierra	Tonerde, Boden, Ackerland, Niemandsland, Erdboden, Erde, Festland, Ackerland, Heimatland
tierras	Tonerde, Boden, Ackerland, Niemandsland, Erdboden, Erde, Festland, Ackerland, Heimatland
tipo	Art, Wechselkurs, Kontotyp, Zinssatz, Zeichensatz, Sorte, Typus, Typ, Figur, Körperbau, Kerl
tipos	Art, Wechselkurs, Kontotyp, Zinssatz, Zeichensatz, Sorte, Typus, Typ, Figur, Körperbau, Kerl
titular	etw.  benennen, etw.  betiteln, Berechtigte, Inhaberin, Berechtigter, Vorkaufsberechtigter, Schlagzeile, Inhaber
tlc	
toda	
todas	
todavía	bislang, dennoch, immer noch, noch, noch immer, noch nicht, trotzdem
todo	alles, immer geradeaus, den ganzen Tag, alle, jedermann, die ganze Zeit, alles umsonst, ganz, geradeaus, sämtlich, jeglicher, Ganze
todos	immer geradeaus, den ganzen Tag, alle, jedermann, die ganze Zeit, alles umsonst, geradeaus, alle, jedermann, jeder, alle anderen, alle Tage, jeden Tag, täglich, jeglicher, Ganze
tolima	
toma	Aufnahme, Wasseranschluss, Machtergreifung, Machtübernahme, Erdung, Steckdose
tomar	jdn./etw. ernst nehmen, jdn. für etw. halten, sich  etw. zu Herzen nehmen, etw. schwernehmen, etw. berücksichtigen, etw. erobern, etw. nehmen, etw. stürmen, sich etw. ausleihen, etw. zu sich nehmen, Notizen machen, einen guten Verlauf nehmen, jdn./etw. lieb gewinnen, jdn. auf den Arm nehmen, den Puls messen, sich sonnen, sonnenbaden, den Stier bei den Hörnern packen, den Stier bei den Hörnern packen, jdn./etw. berücksichtigen, fotografieren, Maßnahmen ergreifen, etw. zur Kenntnis nehmen, von etw.  Notiz nehmen, sich an etw.  beteiligen, teilnehmen an, mitmachen, Vorkehrungen treffen, ein Gläschen trinken, eine Entscheidung treffen, ein Foto machen, einnehmen, trinken
tome	
tonto	blöd, doof, dumm, dämlich, Dummkopf
torneo	Schachturnier, Turnier
torno	CNC-Drehmaschine, Schraubstock, Spinnrad, Zahnarztbohrer, Bohrer
total	ganz, völlig, Ganze, Summe
totalidad	Gesamtheit
totalmente	vollkommen, vollständig
trabaja	arbeitet soviel dass....
trabajadores	
trabajando	
trabajar	arbeiten, arbeiten als, von acht bis drei arbeiten, durcharbeiten
trabajo	Arbeit, Teilzeitarbeit, Beschäftigung, Schwarzarbeit, Teamarbeit, Halbtagsarbeit, Nachtarbeit, Hausarbeit, Gartenarbeit, Teamarbeit, feste Arbeit, Schwarzarbeit, Kinderarbeit, Handarbeit, Nachtarbeit, Schichtarbeit, Saisonarbeit
trabajos	Zwangsarbeit, Arbeit, Teilzeitarbeit, Beschäftigung, Schwarzarbeit, Teamarbeit, Halbtagsarbeit, Nachtarbeit, Hausarbeit, Gartenarbeit, Teamarbeit, feste Arbeit, Schwarzarbeit, Kinderarbeit, Handarbeit, Nachtarbeit, Schichtarbeit, Saisonarbeit
tradicional	traditionell
trae	
traje	Badeanzug, Straßenanzug, Raumanzug, Anzug, Kostüm
tranquilo	besonnen, gelassen, ruhig, still
transmisión	Datenübertragung, Getriebe, Rundfunkübertragung, Übertragung
transporte	Atommülltransport, Atommülltransport, Seetransport, öffentliche Verkehrsmittel, Transport
tras	nach, hinter
trata	Sklavenhandel, Frauenhandel
tratamiento	ambulante Behandlung, Behandlung, Insulinbehandlung, Wasseraufbereitung, Schönheitsbehandlung, Desktop-Publishing  , Textverarbeitung, Therapie, ärztliche Behandlung, Zahnbehandlung, Anrede
tratamientos	ambulante Behandlung, Behandlung, Insulinbehandlung, Wasseraufbereitung, Schönheitsbehandlung, Desktop-Publishing  , Textverarbeitung, Therapie, ärztliche Behandlung, Zahnbehandlung, Anrede
tratando	
tratar	jdn./etw. behandeln, jdn. siezen, etw. verarbeiten, von etw. handeln, versuchen, etw. zu tun, mit etw. handeln
trato	Umgang, Behandlung
través	
tres	drei, drei Grad Kälte, drei Grad minus, drei Grad unter Null, minus drei Grad, drei Wochen
tribunal	Gericht, Nachlassgericht
triunfo	Sieg, Triumph
trámite	Formalität
tránsito	Durchfahrt, Durchreise, Transit, Verkehr
tu	dein
tue	
turismo	Massentourismus, Fremdenverkehr, Personenkraftwagen  , Personenwagen, Agrotourismus, Landtourismus, Tourismus
tus	deine
tutela	Vormundschaft
tuve	
tuvieron	
tuvimos	
tuviste	
tuvo	
twitter	
técnica	Kauffrau, Automatisierungstechnik, Hydrodehnspanntechnik, Technik
técnicas	Kauffrau, Automatisierungstechnik, Hydrodehnspanntechnik, Technik
técnico	technisch, Kaufmann, Trainer
técnicos	Kaufmann, Trainer
término	Ausdruck, Beendigung, Begriff, Vertragsende, Oberbegriff
términos	Ausdruck, Beendigung, Begriff, Vertragsende, Oberbegriff
tío	Onkel, Typ
título	Buchtitel, Titel, Wertpapier, Diplom, Überschrift
títulos	Buchtitel, Titel, Wertpapier, Diplom, Überschrift
tú	du, du schreibst, du selbst
u	oder
ubicación	Lage
ubicada	
ubicado	gelegen
ud	
uds	
un	ein Artikel über die wirtschaftliche Situation, ein bisschen, ein Kilo ..., alles Mögliche, eine Menge, ein ganz lieber Mensch, ein paar Mal, ein bisschen, ein wenig, etwas, noch etwas ..., ein bisschen, ein bisschen, ein wenig, eine Weile später, eine satte Leistung, ein geiler Typ, ein Glas Wasser, ein
una	eine ganze Menge Geduld, ich will Ihnen mal was sagen..., etwa zehn, eine bewusste Lüge, eine Flut von Briefen, eine Prise  Salz, einen Nachmittag pro Woche, ein Mal, eine
unas	eine ganze Menge Geduld, ich will Ihnen mal was sagen..., etwa zehn, eine bewusste Lüge, eine Flut von Briefen, eine Prise  Salz, Manches, einige, ungefähr, einen Nachmittag pro Woche, ein Mal, eine
unidad	Intensivstation, Eliteeinheit, Maßeinheit, Notarztwagen, Notfallkrankenwagen, Einheit, Lektion
unidades	
unido	vereinigt
unidos	
universidad	Volkshochschule, Universität
universidades	Universitäten
universitaria	
unión	Union, Verband, Vereinigung
uno	eins, man, der Reihe nach, einer nach dem anderen, hintereinander, hintereinanderweg, anderthalb
unos	einige, ein paar, ungefähr, der Reihe nach, einer nach dem anderen, hintereinander, hintereinanderweg, anderthalb
urbana	
urbano	Orts-, Stadt-, städtisch
uribe	
usa	
usado	gebraucht
usados	
usar	jdn./etw. nutzen, etw. benutzen, etw. benützen, etw. einsetzen, etw. verwenden, etw. tragen, mit Zahnseide reinigen
uso	Hausgebrauch, Gebrauch, Anschnallpflicht, Verwendung, Bedienung
usted	Sie
ustedes	ihr, Sie
usuario	Anwender, Benutzer, Endbenutzer, Endkunde, Endverbraucher
usuarios	Anwender, Benutzer, Endbenutzer, Endkunde, Endverbraucher
utiliza	
utilización	
utilizado	
utilizar	jdn. benutzen, etw. benutzen, etw. verwenden, von etw. Gebrauch machen
va	geht
vale	Gutschein
valencia	
valle	Jammertal, Tal
valledupar	
valor	Heizwert, Kurswert, Bestellwert, Sollwert, Standardwert, Voreinstellung, Kostbarkeit, Nennwert, Nährwert, Voreinstellung, Voreinstellung, Istwert, Restwert, Rekordwert, Wertpapier, Wert, Mut, Tapferkeit
valores	
vamos	
van	
variables	Regelgröße, Eingangsgröße, unabhängige Variable, Variable
varias	mehrmals, öfters
varios	mehrere
vary	
vas	
vaya	
vayan	
ve	
veamos	
veces	
vehículo	Mietwagen, Notarzteinsatzfahrzeug  , Sondereinsatzfahrzeug, Gefährt, Polizeifahrzeug, Geländewagen
vehículos	Mietwagen, Notarzteinsatzfahrzeug  , Sondereinsatzfahrzeug, Gefährt, Polizeifahrzeug, Geländewagen
velocidad	Landegeschwindigkeit, Drehzahl, Lichtgeschwindigkeit, Schallgeschwindigkeit, Windgeschwindigkeit, Reaktionsgeschwindigkeit, Geschwindigkeit, Höchstgeschwindigkeit
vemos	
ven	
vendedor	fliegender Händler, Straßenverkäufer, Autohändler, Autoverkäufer, Gebrauchtwagenhändler, Verkäufer
vendo	
venezuela	
venga	
vengan	
venido	
venir	zur Sache kommen, auf die Welt kommen, zur Welt kommen, abnehmen, hierherkommen, gelegen kommen, in jds. Auftrag kommen, wie gerufen kommen, kommen
venta	Großhandel, Verkauf, Vertrieb, Absatz, Gasthof
ventaja	Vorsprung, Vorteil
ventas	Großhandel, Verkauf, Vertrieb, Absatz, Gasthof
veo	
ver	sehen, jdn./etw. anschauen, fernsehen
verano	Sommer
veras	
verdad	wahr, Wahrheit, Tatsache
verdadera	
verdadero	richtig, wahrhaftig, wahr, echt, wirklich
verde	blaugrün, hellgrün, grün, versaut
versión	Verfilmung, Testversion, Miniaturversion, Fassung, Endfassung, Originalfassung, Überarbeitung, Version
verte	
verás	
veré	
ves	
vete	
vez	Mal
vi	
viajar	fliegen, reisen, verreisen
viaje	Hinfahrt, Rundreise, Geschäftsreise, Hochzeitsreise, Rückfahrt, Jungfernfahrt, Pauschalreise, Reise
viajeros	Reisender, Schwarzfahrer
victoria	Wahlsieg, Pyrrhussieg, Sieg
vida	Alltag, Arbeitsleben, Leben, Halbwertszeit, Nachtleben, Privatleben
video	Video
vieja	
viejo	alt
viendo	
viene	
vienen	
vienes	
viernes	Freitag  , Schwarzer Freitag, Freitagabend
vigencia	Gültigkeit
vigente	gültig, rechtsgültig, rechtskräftig
vigentes	
vigilancia	Aufsicht, Bewachung, Führungsaufsicht, Überwachung
villavicencio	
vine	
vino	Weißwein, Sherry, Hauswein, Wein  des Hauses, Tischwein, Shaoxing-Reiswein, Schaumwein, französischer Wein, Billigwein, Roséwein, Rotwein, Wein
vio	
violencia	häusliche Gewalt, Gewalt
virtual	virtuell
visita	Besuch, Führung, Konsultation
visión	Überblick, Vision, Vorstellung
vista	Meeresblick, Altersweitsichtigkeit, Sicht, Aussicht, Blick, Sehfähigkeit, Sehkraft, Zollbeamter
viste	
visto	gesehen, hauptverhandlungsfähig
vive	
vivienda	Wohnung  
vivir	jdm. auf der Tasche liegen, schmarotzen, schmarotzen, im Grünen wohnen, in Frieden leben, leben, wohnen
vivo	am Leben, lebendig, gerissen, gewitzt
volver	etw. wieder tun, wiederauferstehen, wieder mit jdm. zusammenkommen, umblättern, jdn. wahnsinnig machen, zurückkehren, zurückkommen
volveré	
volvió	
votación	Abstimmung, Wahl
voto	Stimme, Votum
votos	Stimme, Votum
voy	fahre, gehe, komme
voz	Säuferstimme, Stimme
vuelta	Runde, Rundfahrt, Rückkehr, Rückweg, Wechselgeld, Bummel, Spaziergang, Rückfahrt
vuelto	
vuelva	
vuelve	
válido	gültig
vámonos	
vélez	
vía	über
vías	über Satellit, Atemwege, Harnwege, Zufahrtsstraße, Schmalspur, Klettersteig, Wasserstraße, Gleis, Nervenbahn
víctimas	Opfer
wed	
windows	
xix	
xx	
y	und
ya	bereits, gleich ist es soweit, in Kürze, nicht mehr, da, weil, schon
yo	ich an deiner Stelle, ich, ich bin
york	
zona	Zone, Region	
álbum	
álvaro	
ámbito	Bereich, Finanzbereich, Umkreis, Geltungsbereich
área	Rastplatz
áreas	Rastplatz
él	er selbst, er
énfasis	Gewichtung, Nachdruck
época	Paarungszeit, Brutzeit, Regenzeit, Erntezeit, Epoche, Industriezeitalter, Zeitabschnitt, Zeitraum, Zeitspanne
ésa	
ése	
ésta	das ist ...
éste	
éstos	
éxito	Erfolg
índice	Index, Inhaltsverzeichnis
última	
últimas	letzte Worte
último	letzte, letzter
últimos	
única	
único	einzig, einzigartig, einmalig
útil	nützlich, tauglich